region_id,C11_All_inc_ns_CF_1Ch,C11_All_inc_ns_CF_2C,C11_All_inc_ns_CF_3C,C11_All_inc_ns_CF_4mC,C11_All_inc_ns_CF_T,C11_Tot_CF_1C,C11_Tot_CF_2C,C11_Tot_CF_3C,C11_Tot_CF_4mC,C11_Tot_CF_T
LGA10050,29,27,16,3,75,1766,2055,865,308,4994
LGA10110,19,7,6,4,36,778,921,430,162,2291
LGA10150,22,16,7,3,48,2014,1948,519,132,4613
LGA10200,53,62,46,46,207,3605,3663,1452,906,9626
LGA10250,13,12,13,3,41,1449,1644,641,244,3978
LGA10300,0,0,3,0,3,95,87,49,27,258
LGA10350,125,144,102,70,441,7923,9619,4685,2490,24717
LGA10470,16,25,12,0,53,1386,1652,756,335,4129
LGA10550,13,15,11,4,43,1168,1170,516,196,3050
LGA10600,3,10,3,0,16,449,480,210,83,1222
LGA10650,4,0,0,3,7,255,264,142,81,742
LGA10750,234,226,136,79,675,14902,17724,7180,3283,43089
LGA10800,4,4,0,0,8,201,216,136,98,651
LGA10850,4,5,0,0,9,258,294,171,78,801
LGA10900,37,18,16,6,77,3267,3796,1573,582,9218
LGA10950,5,0,0,0,5,106,119,61,31,317
LGA11000,3,0,0,0,3,75,104,43,17,239
LGA11050,0,3,3,0,6,81,88,54,22,245
LGA11100,23,29,15,0,67,1983,2204,655,160,5002
LGA11150,3,4,3,0,10,82,85,61,32,260
LGA11200,0,0,0,0,0,57,45,27,24,153
LGA11250,17,11,6,4,38,665,613,261,102,1641
LGA11300,20,19,11,3,53,1519,1649,535,169,3872
LGA11350,16,15,6,3,40,1084,1216,419,134,2853
LGA11400,4,8,5,3,20,470,579,342,157,1548
LGA11450,35,37,16,3,91,2501,3831,1566,595,8493
LGA11500,87,101,56,40,284,6700,7547,3154,1611,19012
LGA11520,35,43,11,4,93,3890,4116,1268,271,9545
LGA11550,117,121,70,35,343,7154,7217,2898,1277,18546
LGA11600,3,0,0,0,3,91,110,52,34,287
LGA11700,0,0,0,0,0,66,50,27,17,160
LGA11720,31,38,14,6,89,2102,2234,1016,401,5753
LGA11730,23,20,9,7,59,1691,1787,809,367,4654
LGA11750,0,7,0,0,7,158,199,100,44,501
LGA11800,41,23,18,9,91,2579,2806,1167,422,6974
LGA11860,0,0,4,0,4,61,69,45,31,206
LGA12000,3,0,3,0,6,124,147,116,58,445
LGA12050,4,10,0,0,14,334,415,177,77,1003
LGA12150,3,3,0,0,6,126,115,74,42,357
LGA12200,3,4,3,4,14,251,263,133,54,701
LGA12300,8,6,4,3,21,365,427,202,85,1079
LGA12350,14,13,3,3,33,430,438,241,96,1205
LGA12500,5,4,4,0,13,235,262,120,50,667
LGA12600,24,27,16,3,70,1477,1633,847,332,4289
LGA12700,7,4,3,3,17,360,387,158,77,982
LGA12750,19,18,3,3,43,1194,1092,481,225,2992
LGA12850,167,171,123,62,523,8551,10227,4907,2170,25855
LGA12900,3,3,7,0,13,291,315,212,76,894
LGA12950,6,0,0,0,6,158,153,95,31,437
LGA13010,11,4,5,0,20,279,272,161,52,764
LGA13050,3,6,0,0,9,171,183,69,31,454
LGA13100,90,93,32,18,233,6410,8011,3187,1044,18652
LGA13310,21,24,6,4,55,1106,1084,489,209,2888
LGA13320,20,22,3,0,45,1058,1069,447,162,2736
LGA13340,4,5,3,3,15,398,407,235,118,1158
LGA13380,15,27,17,8,67,1573,1610,784,327,4294
LGA13450,19,27,6,16,68,926,1148,671,248,2993
LGA13500,8,4,0,0,12,146,120,99,52,417
LGA13550,15,5,3,8,31,451,514,247,105,1317
LGA13650,4,3,0,4,11,154,156,109,50,469
LGA13660,5,3,3,3,14,195,190,113,36,534
LGA13700,0,0,0,3,3,118,122,68,43,351
LGA13800,48,52,20,13,133,2754,3260,1585,619,8218
LGA13850,0,0,3,0,3,113,113,60,28,314
LGA13950,57,71,50,25,203,5113,5189,2062,1010,13374
LGA14000,71,93,41,5,210,8251,10968,3950,974,24143
LGA14100,9,9,0,0,18,560,716,345,94,1715
LGA14150,48,58,15,9,130,4203,4577,1474,465,10719
LGA14200,13,9,6,5,33,612,598,311,142,1663
LGA14250,0,4,0,0,4,44,63,47,13,167
LGA14300,5,0,5,3,13,190,214,120,63,587
LGA14350,18,14,7,9,48,907,852,455,216,2430
LGA14400,13,4,7,3,27,811,1033,470,118,2432
LGA14450,43,41,17,4,105,3135,3286,1103,312,7836
LGA14500,37,58,25,3,123,5043,7905,3315,788,17051
LGA14550,8,3,0,0,11,343,288,189,79,899
LGA14600,10,3,0,0,13,257,237,144,62,700
LGA14650,115,120,52,25,312,7877,9541,3719,1121,22258
LGA14700,10,24,5,0,39,1479,1830,711,138,4158
LGA14750,6,5,4,3,18,428,431,235,113,1207
LGA14800,25,11,3,4,43,2588,2420,571,100,5679
LGA14850,12,21,3,5,41,1507,1771,758,289,4325
LGA14870,9,21,8,6,44,711,846,355,129,2041
LGA14900,145,149,94,56,444,8224,11084,4911,2199,26418
LGA14920,7,3,3,0,13,279,276,147,45,747
LGA14950,0,0,3,3,6,122,111,79,38,350
LGA15050,33,42,11,9,95,2984,3623,1452,561,8620
LGA15150,13,15,6,0,34,1647,2206,828,133,4814
LGA15200,37,28,12,0,77,3278,3000,787,223,7288
LGA15270,20,13,15,6,54,869,881,481,176,2407
LGA15300,16,16,5,0,37,483,514,256,132,1385
LGA15350,17,6,7,0,30,1098,1398,621,124,3241
LGA15500,3,3,3,0,9,219,266,141,37,663
LGA15550,0,3,0,0,3,79,89,52,21,241
LGA15650,11,6,6,3,26,605,693,370,124,1792
LGA15700,7,4,6,0,17,580,566,270,122,1538
LGA15750,15,10,15,5,45,477,555,283,118,1433
LGA15800,9,0,0,0,9,216,215,114,63,608
LGA15850,7,3,0,0,10,212,236,143,74,665
LGA15900,50,55,24,8,137,5870,6440,2399,658,15367
LGA15950,19,19,5,0,43,2509,1801,429,85,4824
LGA16100,4,3,3,0,10,200,214,119,37,570
LGA16150,9,25,3,10,47,1418,1682,800,291,4191
LGA16180,9,4,4,0,17,630,810,343,111,1894
LGA16200,9,6,7,4,26,518,491,344,172,1525
LGA16250,119,103,39,46,307,8615,8320,2941,1495,21371
LGA16350,121,147,73,35,376,8214,9881,4229,1715,24039
LGA16370,38,39,12,3,92,2543,3681,1417,314,7955
LGA16380,40,33,14,5,92,2523,2867,1192,423,7005
LGA16400,34,38,24,11,107,2429,2927,1252,471,7079
LGA16470,15,19,8,0,42,1707,2074,789,221,4791
LGA16550,75,54,21,7,157,5249,5937,1851,375,13412
LGA16610,12,8,3,3,26,789,786,418,199,2192
LGA16650,87,48,30,16,181,4968,4779,1663,641,12051
LGA16700,39,49,19,3,110,5212,5821,1847,350,13230
LGA16900,41,41,26,6,114,2770,3547,1367,542,8226
LGA16950,51,43,19,10,123,3205,3466,1473,575,8719
LGA17000,11,21,10,3,45,981,1256,561,201,2999
LGA17050,4,8,0,0,12,255,353,102,28,738
LGA17100,24,17,11,4,56,1800,1904,672,258,4634
LGA17150,99,123,44,8,274,9737,13297,5364,1310,29708
LGA17200,41,28,3,5,77,4365,2598,522,92,7577
LGA17310,41,39,13,4,97,2174,2340,1052,364,5930
LGA17350,6,4,0,0,10,195,214,122,68,599
LGA17400,3,3,3,3,12,226,196,107,63,592
LGA17420,85,94,34,15,228,8756,12955,4893,1362,27966
LGA17450,5,6,4,0,15,102,116,60,39,317
LGA17500,6,8,6,3,23,414,507,218,93,1232
LGA17550,52,55,17,15,139,3077,3238,1428,497,8240
LGA17620,11,11,6,0,28,558,611,310,92,1571
LGA17640,4,5,3,0,12,262,298,165,58,783
LGA17650,0,4,5,0,9,248,272,125,64,709
LGA17700,0,0,0,0,0,29,43,29,17,118
LGA17750,30,25,11,5,71,2185,2539,1291,518,6533
LGA17800,0,0,0,7,7,134,155,85,25,399
LGA17850,3,3,0,0,6,114,121,62,24,321
LGA17900,8,7,3,3,21,208,166,103,58,535
LGA17950,0,0,0,0,0,110,106,57,18,291
LGA18000,81,92,31,6,210,6494,8965,3224,717,19400
LGA18020,6,0,3,3,12,273,349,198,89,909
LGA18050,38,36,5,6,85,2404,2612,924,185,6125
LGA18100,3,0,3,3,9,134,123,82,27,366
LGA18150,7,5,3,0,15,271,273,169,71,784
LGA18200,9,4,3,0,16,240,266,139,60,705
LGA18250,30,29,5,5,69,3425,4071,1355,232,9083
LGA18350,17,28,7,4,56,1570,1928,919,362,4779
LGA18400,46,59,29,7,141,1932,2560,1275,481,6248
LGA18450,93,95,38,25,251,7936,9796,3814,1170,22716
LGA18500,19,32,10,0,61,1934,2100,848,195,5077
LGA18550,92,103,35,22,252,5617,6698,2876,1100,16291
LGA18710,3,4,3,0,10,639,821,388,137,1985
LGA18750,7,6,3,0,16,428,500,269,131,1328
LGA19399,3,3,0,0,6,52,46,19,8,125
LGA20110,6,7,0,0,13,415,502,221,69,1207
LGA20260,9,3,3,3,18,406,404,189,87,1086
LGA20570,39,48,26,10,123,3373,4001,1801,628,9803
LGA20660,62,83,25,14,184,5433,6841,2371,620,15265
LGA20740,14,25,10,3,52,997,1116,493,142,2748
LGA20830,27,38,17,14,96,1571,2002,1018,393,4984
LGA20910,49,55,18,3,125,3771,6058,2358,423,12610
LGA21010,9,9,4,0,22,491,502,233,89,1315
LGA21110,69,87,30,6,192,6566,9824,4016,812,21218
LGA21180,235,198,99,51,583,8891,9879,3933,1359,24062
LGA21270,4,3,3,3,13,213,235,138,78,664
LGA21370,22,29,13,11,75,1283,1451,804,327,3865
LGA21450,64,83,24,12,183,3229,4267,1920,717,10133
LGA21610,206,252,112,58,628,12162,16182,6205,2666,37215
LGA21670,13,8,4,0,25,428,412,219,85,1144
LGA21750,16,11,6,4,37,742,802,429,173,2146
LGA21830,4,13,15,3,35,553,677,430,185,1845
LGA21890,97,82,35,17,231,5887,6511,2158,585,15141
LGA22110,33,29,12,11,85,1428,1576,676,262,3942
LGA22170,94,87,46,22,249,5363,6330,2364,762,14819
LGA22250,7,3,3,4,17,344,349,231,99,1023
LGA22310,57,80,33,14,184,5801,7548,2584,665,16598
LGA22410,7,14,3,0,24,753,879,337,111,2080
LGA22490,16,18,10,5,49,810,1111,551,187,2659
LGA22620,52,45,26,13,136,3887,4299,1982,755,10923
LGA22670,137,130,73,54,394,6736,6561,2441,1148,16886
LGA22750,145,127,62,20,354,8351,9998,4104,1252,23705
LGA22830,43,62,27,15,147,2281,2721,1247,565,6814
LGA22910,8,3,10,0,21,513,539,242,82,1376
LGA22980,3,3,3,0,9,207,236,105,38,586
LGA23110,74,60,20,11,165,3832,4556,1493,509,10390
LGA23190,13,9,13,4,39,707,840,399,126,2072
LGA23270,148,184,97,76,505,7508,9794,4551,2194,24047
LGA23350,3,16,3,0,22,583,734,306,111,1734
LGA23430,105,121,36,6,268,6752,8385,2757,584,18478
LGA23670,114,141,42,18,315,7381,9611,3499,962,21453
LGA23810,70,50,25,11,156,2802,3126,1277,493,7698
LGA23940,8,0,4,3,15,249,247,144,60,700
LGA24130,27,26,19,3,75,1766,2462,1099,347,5674
LGA24210,91,77,38,3,209,5846,7295,2632,547,16320
LGA24250,6,4,0,0,10,249,293,125,52,719
LGA24330,60,46,13,9,128,3202,3122,910,296,7530
LGA24410,64,86,34,7,191,4621,5788,2369,623,13401
LGA24600,19,14,4,12,49,2310,1296,322,153,4081
LGA24650,75,101,52,21,249,5312,6970,2735,894,15911
LGA24780,47,38,25,12,122,1829,2098,1087,423,5437
LGA24850,22,38,24,4,88,1376,1790,849,304,4319
LGA24900,23,20,23,5,71,985,1018,610,278,2891
LGA24970,106,94,21,8,229,8486,10034,2799,636,21955
LGA25060,72,65,31,16,184,4698,5822,2281,511,13312
LGA25150,19,17,17,3,56,1172,1522,707,256,3657
LGA25250,91,90,42,28,251,6169,6754,2309,914,16146
LGA25340,104,116,46,19,285,5311,7125,2793,837,16066
LGA25430,13,11,7,0,31,623,667,312,104,1706
LGA25490,15,7,8,4,34,617,732,432,162,1943
LGA25620,17,15,5,4,41,500,613,209,78,1400
LGA25710,41,36,21,4,102,2744,4645,1939,491,9819
LGA25810,8,7,0,3,18,414,478,195,84,1171
LGA25900,27,24,9,0,60,3041,2488,635,159,6323
LGA25990,7,3,3,3,16,231,232,146,49,658
LGA26080,0,4,0,0,4,82,129,39,13,263
LGA26170,9,21,16,8,54,974,1134,564,219,2891
LGA26260,8,8,8,0,24,584,689,372,120,1765
LGA26350,36,42,27,6,111,3197,3736,1450,308,8691
LGA26430,4,7,4,0,15,340,333,132,56,861
LGA26490,14,16,11,3,44,1034,1453,648,161,3296
LGA26610,23,12,9,12,56,757,761,465,198,2181
LGA26670,0,6,5,0,11,184,254,139,41,618
LGA26700,15,13,5,7,40,1034,1146,584,193,2957
LGA26730,20,15,4,4,43,1132,1356,685,251,3424
LGA26810,30,25,17,9,81,1499,1678,872,303,4352
LGA26890,0,4,0,0,4,157,180,89,30,456
LGA26980,69,90,25,3,187,6935,8825,2949,656,19365
LGA27070,159,168,76,33,436,7885,9940,3698,1163,22686
LGA27170,13,23,4,3,43,1376,1661,750,228,4015
LGA27260,128,136,57,38,359,8343,9546,3602,1388,22879
LGA27350,23,19,13,13,68,2418,2217,543,149,5327
LGA27450,118,144,73,20,355,6360,8403,3593,1114,19470
LGA27630,6,5,3,0,14,224,263,139,58,684
LGA29399,0,0,0,0,0,4,13,0,0,17
LGA30250,0,7,3,3,13,43,39,21,28,131
LGA30300,7,7,4,0,18,173,184,123,54,534
LGA30370,18,17,4,3,42,575,682,361,146,1764
LGA30410,6,4,4,3,17,136,147,63,28,374
LGA30450,0,0,0,0,0,9,13,6,0,28
LGA30760,3,0,0,0,3,88,93,45,17,243
LGA30900,0,3,3,0,6,9,19,15,4,47
LGA31000,452,466,180,89,1187,43728,50912,18808,5887,119335
LGA31750,3,0,0,0,3,15,15,4,3,37
LGA31820,68,50,32,12,162,3251,3411,1473,717,8852
LGA31900,15,9,6,7,37,690,776,382,136,1984
LGA31950,0,0,0,0,0,12,11,3,3,29
LGA32070,107,83,49,37,276,6085,6663,2491,1095,16334
LGA32250,3,0,6,3,12,53,54,25,30,162
LGA32260,27,18,14,8,67,1081,1050,484,230,2845
LGA32270,24,28,20,9,81,1176,1466,739,303,3684
LGA32310,16,18,5,6,45,412,488,234,125,1259
LGA32330,0,0,0,0,0,22,23,20,38,103
LGA32450,4,0,3,3,10,92,95,53,36,276
LGA32500,7,3,0,3,13,89,115,56,35,295
LGA32600,0,0,0,0,0,9,15,7,0,31
LGA32750,0,0,0,0,0,16,10,0,0,26
LGA32770,0,0,0,0,0,45,28,31,46,150
LGA33100,0,3,0,0,3,37,29,22,6,94
LGA33200,3,3,0,0,6,66,55,38,19,178
LGA33220,63,76,24,14,177,3316,3481,1475,681,8953
LGA33360,44,43,23,11,121,2565,2992,1246,472,7275
LGA33430,341,319,91,45,796,20724,23015,7988,2524,54251
LGA33610,8,6,3,3,20,377,443,269,94,1183
LGA33620,29,28,13,7,77,1571,1763,787,383,4504
LGA33800,14,8,10,0,32,476,511,223,73,1283
LGA33830,3,0,0,3,6,27,34,22,22,105
LGA33960,133,101,49,37,320,7179,7920,3383,1696,20178
LGA33980,19,33,10,3,65,873,1251,590,220,2934
LGA34420,3,0,0,0,3,39,32,14,16,101
LGA34570,0,0,0,0,0,6,9,9,10,34
LGA34580,27,26,17,14,84,1307,1333,726,403,3769
LGA34590,198,253,107,100,658,12480,13677,5725,3101,34983
LGA34710,0,3,3,0,6,154,158,83,58,453
LGA34770,83,107,42,20,252,4952,5738,2442,852,13984
LGA34800,3,0,0,0,3,39,27,15,4,85
LGA34830,0,0,0,0,0,8,5,0,6,19
LGA34860,13,15,6,4,38,511,552,289,121,1473
LGA35010,215,221,107,52,595,16149,19915,7979,3089,47132
LGA35250,0,0,0,0,0,27,26,18,35,106
LGA35300,11,21,9,8,49,780,853,394,190,2217
LGA35600,5,5,0,0,10,181,206,88,36,511
LGA35670,0,0,0,0,0,25,25,14,21,85
LGA35760,14,5,0,4,23,373,347,179,81,980
LGA35780,0,3,0,3,6,76,54,39,70,239
LGA35790,0,0,0,0,0,54,42,32,61,189
LGA35800,0,0,0,0,0,72,48,28,23,171
LGA36070,0,0,0,0,0,38,8,13,6,65
LGA36150,3,0,3,0,6,43,37,16,9,105
LGA36250,84,89,39,9,221,6185,7932,3024,906,18047
LGA36300,3,3,0,0,6,37,31,20,7,95
LGA36360,75,64,31,28,198,4299,4647,2020,866,11832
LGA36510,22,30,9,7,68,1430,1607,770,341,4148
LGA36580,14,25,11,3,53,882,906,432,185,2405
LGA36630,30,21,22,8,81,1040,1152,591,301,3084
LGA36660,24,29,12,10,75,1234,1294,635,346,3509
LGA36710,162,191,67,17,437,11880,14342,5257,1695,33174
LGA36810,32,42,17,13,104,1473,1631,734,377,4215
LGA36910,79,88,40,21,228,5722,6446,3123,1400,16691
LGA36950,4,6,0,5,15,101,92,60,79,332
LGA36960,0,3,0,0,3,136,110,100,103,449
LGA37010,105,101,42,25,273,7323,7826,3301,1275,19725
LGA37300,0,3,3,3,9,135,163,72,40,410
LGA37310,24,28,10,4,66,1142,1303,697,339,3481
LGA37340,32,17,13,6,68,1167,1206,474,146,2993
LGA37400,3,3,4,0,10,54,46,24,16,140
LGA37550,3,0,0,0,3,22,11,18,23,74
LGA37570,0,0,0,0,0,21,12,0,3,36
LGA37600,0,0,0,0,0,52,41,30,73,196
LGA39399,0,0,0,0,0,0,0,0,0,0
LGA40070,3,0,3,0,6,417,231,59,17,724
LGA40120,11,33,7,0,51,1809,2444,910,277,5440
LGA40220,7,12,14,3,36,777,967,413,150,2307
LGA40250,6,0,3,0,9,99,64,51,23,237
LGA40310,7,9,4,4,24,949,1197,475,142,2763
LGA40430,0,0,3,0,3,70,79,47,16,212
LGA40520,7,4,3,3,17,401,411,186,66,1064
LGA40700,16,11,9,0,36,1656,2358,868,193,5075
LGA40910,28,31,8,5,72,2193,2740,869,201,6003
LGA41010,4,3,0,0,7,120,129,65,34,348
LGA41060,47,47,24,11,129,4426,5213,1572,430,11641
LGA41140,4,3,0,0,7,291,383,193,57,924
LGA41190,0,0,0,0,0,52,74,45,14,185
LGA41330,3,0,3,0,6,53,46,16,12,127
LGA41560,11,3,6,0,20,430,473,193,66,1162
LGA41750,0,0,3,0,3,54,35,26,9,124
LGA41830,3,0,0,0,3,52,60,22,18,152
LGA41960,0,0,3,0,3,49,43,30,8,130
LGA42030,10,14,10,0,34,849,950,324,112,2235
LGA42110,0,4,0,0,4,143,155,83,31,412
LGA42250,8,8,3,0,19,314,455,206,57,1032
LGA42600,12,5,4,4,25,1307,1429,518,93,3347
LGA42750,0,3,3,0,6,167,161,69,20,417
LGA43080,3,0,0,0,3,43,35,31,9,118
LGA43220,0,0,0,0,0,46,50,30,3,129
LGA43360,4,0,0,0,4,86,89,33,10,218
LGA43650,6,11,0,3,20,591,887,372,111,1961
LGA43710,0,4,0,6,10,181,245,121,48,595
LGA43790,6,8,3,0,17,411,490,224,64,1189
LGA43920,7,8,3,0,18,396,478,181,66,1121
LGA44000,0,0,0,0,0,0,3,3,0,6
LGA44060,24,41,6,6,77,3721,3958,1285,339,9303
LGA44210,5,5,0,0,10,277,279,127,40,723
LGA44340,20,31,8,3,62,2790,3736,1233,314,8073
LGA44550,13,7,4,6,30,1237,1741,707,222,3907
LGA44620,12,6,3,7,28,929,1068,473,150,2620
LGA44830,0,6,0,0,6,94,111,54,20,279
LGA45040,10,15,5,0,30,704,777,364,125,1970
LGA45090,10,9,0,0,19,336,409,158,38,941
LGA45120,3,0,0,0,3,161,174,97,41,473
LGA45290,9,13,6,0,28,1283,1527,466,94,3370
LGA45340,70,84,23,12,189,6979,8531,2870,943,19323
LGA45400,0,0,0,0,0,27,31,15,9,82
LGA45540,0,0,3,0,3,44,42,18,9,113
LGA45680,51,59,23,20,153,3118,3253,1428,748,8547
LGA45890,66,54,23,15,158,4712,4805,1507,552,11576
LGA46090,4,7,5,3,19,515,533,201,84,1333
LGA46300,7,3,6,3,19,508,598,265,67,1438
LGA46450,6,9,4,4,23,599,674,324,137,1734
LGA46510,10,20,0,3,33,883,1142,345,78,2448
LGA46670,5,10,3,3,21,329,384,189,52,954
LGA46860,0,0,0,3,3,33,60,30,9,132
LGA46970,0,4,0,0,4,200,262,126,23,611
LGA47140,78,69,34,27,208,5825,6109,2284,979,15197
LGA47290,0,3,0,0,3,73,100,43,12,228
LGA47490,0,3,0,0,3,75,90,47,12,224
LGA47630,3,7,0,3,13,233,311,177,48,769
LGA47700,39,56,12,7,114,4490,5632,1798,482,12402
LGA47800,5,3,3,0,11,193,218,116,40,567
LGA47910,0,3,0,0,3,88,99,59,11,257
LGA47980,11,17,7,0,35,1458,1919,620,144,4141
LGA48050,4,3,3,0,10,350,415,178,43,986
LGA48130,3,10,3,3,19,250,269,118,70,707
LGA48260,4,3,0,3,10,263,352,129,29,773
LGA48340,8,5,4,0,17,433,491,266,73,1263
LGA48410,21,28,0,8,57,2219,2437,713,207,5576
LGA48540,20,14,11,0,45,875,894,336,129,2234
LGA48640,3,0,0,0,3,59,62,26,14,161
LGA48750,0,7,0,0,7,137,172,59,9,377
LGA48830,8,6,0,0,14,295,383,178,54,910
LGA49399,4,13,6,4,27,133,98,58,30,319
LGA50080,17,11,15,6,49,1265,1460,618,273,3616
LGA50210,39,31,15,3,88,2773,2898,1213,586,7470
LGA50250,3,0,6,0,9,233,354,168,56,811
LGA50280,3,8,6,0,17,490,561,234,38,1323
LGA50350,0,5,6,0,11,577,669,239,65,1550
LGA50420,33,35,10,7,85,2684,2781,870,264,6599
LGA50490,19,19,3,9,50,1463,1250,470,175,3358
LGA50560,0,3,0,0,3,56,54,23,13,146
LGA50630,3,0,0,0,3,73,80,39,14,206
LGA50770,3,3,0,0,6,54,76,32,12,174
LGA50840,5,3,0,0,8,140,183,79,38,440
LGA50910,3,0,3,3,9,41,38,9,12,100
LGA50980,10,12,6,5,33,506,582,243,134,1465
LGA51080,0,4,0,0,4,46,53,27,15,141
LGA51120,0,0,0,0,0,29,38,18,12,97
LGA51190,13,22,6,0,41,1199,1213,434,150,2996
LGA51260,10,22,3,0,35,1099,1562,594,204,3459
LGA51310,4,12,0,0,16,955,1628,723,158,3464
LGA51330,44,47,22,14,127,3767,4607,1717,543,10634
LGA51400,9,15,6,0,30,601,948,383,128,2060
LGA51470,0,0,0,4,4,14,31,9,4,58
LGA51540,3,9,3,0,15,188,221,90,51,550
LGA51610,0,0,0,0,0,57,77,22,5,161
LGA51680,3,3,3,0,9,191,243,114,37,585
LGA51750,3,3,3,0,9,297,443,191,28,959
LGA51820,60,61,13,10,144,4283,5307,1867,531,11988
LGA51890,6,10,0,0,16,381,394,165,65,1005
LGA51960,3,3,0,3,9,149,163,85,39,436
LGA52030,0,4,0,0,4,32,47,17,0,96
LGA52100,0,0,0,0,0,31,38,24,4,97
LGA52170,3,0,0,0,3,277,367,174,49,867
LGA52240,3,0,3,0,6,40,39,26,11,116
LGA52310,0,0,3,0,3,32,41,21,7,101
LGA52380,0,0,0,4,4,3,0,0,8,11
LGA52450,0,0,0,0,0,47,55,26,6,134
LGA52520,0,3,0,0,3,60,43,41,16,160
LGA52590,0,8,0,0,8,103,113,56,21,293
LGA52660,5,8,3,3,19,527,690,265,110,1592
LGA52730,3,3,0,0,6,176,207,71,33,487
LGA52800,3,10,3,3,19,158,193,116,79,546
LGA52870,0,6,0,0,6,192,260,96,43,591
LGA52940,3,3,0,0,6,30,19,23,3,75
LGA53010,0,0,0,0,0,28,15,19,9,71
LGA53080,0,5,0,0,5,26,30,10,5,71
LGA53150,3,3,3,0,9,281,412,165,24,882
LGA53220,10,8,7,6,31,229,307,158,80,774
LGA53290,14,9,5,4,32,490,643,281,104,1518
LGA53360,3,0,0,3,6,93,108,31,10,242
LGA53430,8,10,5,3,26,1021,1025,337,86,2469
LGA53520,16,27,13,11,67,1439,1630,722,310,4101
LGA53570,0,3,0,0,3,153,197,74,41,465
LGA53640,0,0,0,0,0,43,56,31,20,150
LGA53710,0,0,0,0,0,37,39,21,11,108
LGA53780,66,74,26,17,183,4911,5545,2188,962,13606
LGA53920,0,0,4,0,4,80,69,48,73,270
LGA53990,10,12,7,4,33,1016,1276,544,175,3011
LGA54060,7,3,3,0,13,130,159,84,19,392
LGA54130,0,0,0,0,0,49,54,25,6,134
LGA54170,66,75,34,15,190,7418,10319,3602,875,22214
LGA54200,27,34,6,8,75,2364,2919,1134,395,6812
LGA54280,26,18,12,6,62,1232,1414,687,243,3576
LGA54340,3,3,0,3,9,154,165,105,45,469
LGA54410,0,0,0,3,3,37,52,24,15,128
LGA54480,0,0,0,0,0,13,33,20,3,69
LGA54550,0,0,0,3,3,79,92,35,15,221
LGA54620,0,0,0,0,0,29,42,15,11,97
LGA54690,0,0,0,0,0,17,22,9,3,51
LGA54760,0,0,0,0,0,40,38,18,10,106
LGA54830,20,12,11,6,49,1268,1291,570,264,3393
LGA54900,0,0,0,0,0,52,58,33,12,155
LGA54970,0,0,0,0,0,18,17,9,12,56
LGA55040,3,3,0,0,6,37,68,23,15,143
LGA55110,37,40,13,4,94,2528,2972,1109,395,7004
LGA55180,0,0,0,0,0,333,383,196,79,991
LGA55250,3,3,3,0,9,33,18,12,8,71
LGA55320,33,30,15,4,82,4217,5637,2031,481,12366
LGA55390,0,0,0,0,0,15,7,0,3,25
LGA55460,0,5,0,0,5,122,126,73,25,346
LGA55530,0,0,0,0,0,18,25,8,3,54
LGA55600,3,0,0,0,3,108,101,50,31,290
LGA55670,3,0,0,0,3,24,40,19,12,95
LGA55740,0,3,3,0,6,283,423,174,41,921
LGA55810,0,0,0,0,0,30,8,4,8,50
LGA55880,0,0,0,0,0,19,26,10,6,61
LGA55950,3,0,0,0,3,25,19,12,0,56
LGA56020,0,0,0,0,0,19,25,10,12,66
LGA56090,21,27,11,5,64,1568,1932,823,272,4595
LGA56160,0,0,0,0,0,3,6,0,0,9
LGA56230,9,10,0,3,22,499,657,269,104,1529
LGA56300,0,0,0,3,3,39,37,26,9,111
LGA56370,0,3,0,0,3,37,28,16,9,90
LGA56450,0,0,3,0,3,37,50,17,9,113
LGA56520,7,3,0,0,10,129,160,92,35,416
LGA56580,4,14,4,3,25,821,1357,614,158,2950
LGA56620,3,3,3,0,9,57,44,25,10,136
LGA56730,4,3,4,4,15,330,426,193,94,1043
LGA56790,0,3,4,3,10,103,121,65,18,307
LGA56860,0,0,0,0,0,4,8,0,9,21
LGA56930,0,3,0,0,3,43,81,38,26,188
LGA57000,0,0,0,0,0,26,29,12,6,73
LGA57080,4,3,0,0,7,431,151,26,3,611
LGA57140,3,0,0,0,3,43,41,22,6,112
LGA57210,5,4,0,0,9,182,193,86,31,492
LGA57280,16,11,8,3,38,548,517,251,103,1419
LGA57350,3,0,3,0,6,28,37,13,11,89
LGA57420,4,3,0,0,7,69,94,48,10,221
LGA57490,54,50,19,10,133,4449,5786,2237,846,13318
LGA57560,12,17,0,3,32,733,1040,370,130,2273
LGA57630,0,0,0,0,0,3,4,0,0,7
LGA57700,13,15,3,3,34,811,1019,459,216,2505
LGA57770,0,0,0,0,0,32,31,11,0,74
LGA57840,4,12,3,3,22,1504,1691,576,110,3881
LGA57910,96,96,42,28,262,7988,9114,3109,942,21153
LGA57980,0,0,0,0,0,612,738,209,30,1589
LGA58050,50,76,32,19,177,4916,6213,2341,921,14391
LGA58190,0,0,0,0,0,17,15,12,4,48
LGA58260,0,0,0,0,0,14,27,13,7,61
LGA58330,6,0,0,0,6,181,150,76,37,444
LGA58400,0,0,0,0,0,11,10,6,0,27
LGA58470,0,0,0,0,0,12,3,0,4,19
LGA58510,7,14,0,0,21,1276,1041,287,81,2685
LGA58540,0,0,0,0,0,34,45,22,12,113
LGA58570,9,9,4,0,22,1166,1218,344,80,2808
LGA58610,0,0,3,0,3,57,71,38,21,187
LGA58680,0,0,0,0,0,24,22,8,3,57
LGA58760,81,96,58,28,263,6934,9490,3598,1402,21424
LGA58820,3,0,3,0,6,128,165,76,24,393
LGA58890,0,3,3,0,6,38,40,25,3,106
LGA59030,0,0,0,0,0,12,8,3,0,23
LGA59100,0,3,0,0,3,30,24,13,12,79
LGA59170,0,0,0,0,0,39,31,22,6,98
LGA59250,0,0,0,0,0,10,13,9,3,35
LGA59310,0,0,0,0,0,63,54,28,10,155
LGA59320,0,0,0,0,0,18,24,6,0,48
LGA59330,0,0,0,0,0,22,21,9,0,52
LGA59340,0,8,3,0,11,197,264,110,68,639
LGA59350,0,0,0,0,0,6,6,3,3,18
LGA59360,0,3,0,0,3,51,60,25,12,148
LGA59370,4,3,0,3,10,117,138,63,18,336
LGA59399,0,0,0,0,0,0,0,0,0,0
LGA60210,0,4,3,3,10,205,210,81,27,523
LGA60410,12,17,6,3,38,649,721,300,118,1788
LGA60610,13,5,0,5,23,736,823,323,142,2024
LGA60810,17,8,3,3,31,853,968,379,141,2341
LGA61010,3,0,0,0,3,77,88,26,18,209
LGA61210,4,3,6,0,13,306,359,194,87,946
LGA61410,23,12,9,5,49,2253,2459,876,302,5890
LGA61510,4,9,3,0,16,453,475,173,74,1175
LGA61610,14,12,8,3,37,930,998,384,175,2487
LGA61810,7,10,0,0,17,225,274,139,59,697
LGA62010,3,3,0,0,6,34,21,6,3,64
LGA62210,6,3,3,0,12,270,256,129,43,698
LGA62410,3,0,0,0,3,113,131,68,17,329
LGA62610,18,16,5,7,46,1837,1703,658,290,4488
LGA62810,16,12,3,3,34,1793,2055,636,191,4675
LGA63010,8,10,5,0,23,630,631,309,132,1702
LGA63210,5,5,3,0,13,254,285,105,54,698
LGA63410,0,0,3,0,3,53,51,25,6,135
LGA63610,9,11,3,0,23,1453,1827,669,252,4201
LGA63810,0,0,3,0,3,375,465,189,52,1081
LGA64010,21,23,16,3,63,2393,2610,1044,370,6417
LGA64210,15,5,5,0,25,827,944,372,139,2282
LGA64610,7,6,3,3,19,510,580,226,102,1418
LGA64810,10,0,6,0,16,616,569,221,80,1486
LGA65010,6,3,3,3,15,272,288,117,55,732
LGA65210,4,3,0,0,7,78,78,23,14,193
LGA65410,9,8,3,0,20,526,589,271,94,1480
LGA65610,3,0,0,0,3,188,189,78,30,485
LGA65810,8,7,6,3,24,854,1135,438,148,2575
LGA69399,0,0,0,0,0,0,0,0,0,0
LGA70200,26,13,9,5,53,1018,1001,437,202,2658
LGA70420,24,14,15,10,63,200,179,132,111,622
LGA70540,0,0,0,0,0,4,3,8,0,15
LGA70620,3,12,9,5,29,134,112,79,59,384
LGA70700,0,3,0,0,3,30,28,15,3,76
LGA71000,37,43,18,17,115,2986,2878,1111,470,7445
LGA71300,8,0,3,3,14,275,233,178,195,881
LGA72200,6,4,6,0,16,329,356,186,86,957
LGA72300,14,14,5,3,36,765,901,332,167,2165
LGA72330,19,5,10,5,39,177,140,92,73,482
LGA72800,12,13,5,10,40,1181,1446,605,244,3476
LGA73600,6,7,11,12,36,177,176,131,139,623
LGA74050,0,0,4,0,4,84,81,61,55,281
LGA74500,0,0,0,6,6,185,176,132,155,648
LGA74560,0,0,0,0,0,13,15,0,0,28
LGA74660,4,0,0,3,7,210,191,110,139,650
LGA79399,6,5,0,0,11,296,346,147,64,853
LGA89399,92,107,50,9,258,15770,18859,6586,1981,43196
LGA99399,6,0,0,0,6,129,99,51,16,295
