region_id,C11_All_in_ns_1PF_1C,C11_All_in_ns_1PF_2C,C11_All_in_ns_1PF_3C,C11_All_in_ns_1_pa_fa_4m_c,C11_All_in_ns_1_pa_fa_w_To,C11_Tot_1PF_1C,C11_Tot_1PF_2C,C11_Tot_1PF_3C,C11_Tot_1_pa_fa_4mor_ch,C11_Tot_T
LGA10050,32,15,5,4,56,1227,639,235,107,2208
LGA10110,16,6,6,3,31,574,292,114,69,1049
LGA10150,24,13,3,0,40,1070,360,82,15,1527
LGA10200,53,17,11,12,93,1561,789,303,152,2805
LGA10250,29,9,3,6,47,1157,554,156,67,1934
LGA10300,6,0,0,0,6,43,19,9,3,74
LGA10350,139,78,47,30,294,4761,2695,1041,571,9068
LGA10470,22,12,4,3,41,882,455,199,92,1628
LGA10550,20,17,7,0,44,737,392,148,60,1337
LGA10600,0,8,0,0,8,402,197,70,27,696
LGA10650,3,3,3,0,9,156,75,38,3,272
LGA10750,289,150,49,59,547,7919,4686,1919,1137,15661
LGA10800,7,0,0,0,7,109,48,19,11,187
LGA10850,3,0,0,0,3,171,68,27,15,281
LGA10900,24,14,5,3,46,1831,953,276,118,3178
LGA10950,3,3,0,0,6,71,31,15,13,130
LGA11000,0,0,0,0,0,55,25,6,9,95
LGA11050,3,0,0,0,3,55,26,6,7,94
LGA11100,26,14,0,3,43,1119,540,123,45,1827
LGA11150,14,0,3,5,22,70,22,18,11,121
LGA11200,0,3,0,3,6,59,35,17,9,120
LGA11250,19,10,5,8,42,569,297,127,54,1047
LGA11300,16,3,3,3,25,789,346,85,31,1251
LGA11350,16,5,4,4,29,1082,443,133,29,1687
LGA11400,3,3,3,0,9,229,127,36,27,419
LGA11450,23,15,6,5,49,1052,707,311,110,2180
LGA11500,149,77,37,28,291,4435,2619,1105,557,8716
LGA11520,24,16,7,0,47,1612,733,167,32,2544
LGA11550,118,49,29,13,209,3833,1737,562,229,6361
LGA11600,4,0,0,0,4,41,24,10,11,86
LGA11700,3,0,0,0,3,70,18,17,14,119
LGA11720,54,25,10,3,92,1546,805,308,139,2798
LGA11730,46,20,12,4,82,1347,698,279,133,2457
LGA11750,8,0,0,0,8,110,33,19,12,174
LGA11800,53,29,14,8,104,1976,1046,365,166,3553
LGA11860,0,0,0,0,0,17,13,0,0,30
LGA12000,0,0,0,0,0,71,38,19,12,140
LGA12050,5,4,0,0,9,238,107,41,16,402
LGA12150,5,4,0,4,13,110,65,41,18,234
LGA12200,5,0,3,0,8,173,74,36,19,302
LGA12300,15,0,0,0,15,207,105,52,17,381
LGA12350,11,3,4,3,21,233,125,63,34,455
LGA12500,13,5,0,0,18,198,97,37,22,354
LGA12600,44,16,10,5,75,1017,567,237,146,1967
LGA12700,5,6,0,0,11,185,88,37,14,324
LGA12750,38,14,6,6,64,878,469,145,97,1589
LGA12850,170,114,51,25,360,5612,3625,1336,654,11227
LGA12900,7,3,3,3,16,223,113,53,23,412
LGA12950,3,0,5,0,8,99,56,34,12,201
LGA13010,14,6,3,0,23,209,103,50,25,387
LGA13050,3,0,0,0,3,92,50,15,8,165
LGA13100,108,46,17,11,182,4449,2308,842,247,7846
LGA13310,18,12,0,3,33,758,374,146,42,1320
LGA13320,39,13,0,0,52,910,427,155,78,1570
LGA13340,6,5,5,0,16,181,86,49,22,338
LGA13380,50,18,12,10,90,1321,668,237,154,2380
LGA13450,21,5,3,3,32,490,244,107,53,894
LGA13500,3,3,3,0,9,69,32,20,4,125
LGA13550,10,12,3,0,25,277,147,75,33,532
LGA13650,0,3,3,0,6,96,38,21,20,175
LGA13660,5,4,0,0,9,97,42,25,3,167
LGA13700,3,0,0,0,3,77,33,16,6,132
LGA13800,44,16,9,3,72,1531,862,330,106,2829
LGA13850,6,3,0,3,12,62,42,15,12,131
LGA13950,68,33,14,13,128,2590,1337,482,223,4632
LGA14000,48,31,5,0,84,2942,1609,443,103,5097
LGA14100,6,0,3,0,9,222,106,33,3,364
LGA14150,40,13,5,3,61,2014,968,246,80,3308
LGA14200,11,15,4,0,30,373,224,89,55,741
LGA14250,5,0,0,0,5,26,8,0,3,37
LGA14300,3,0,0,0,3,136,55,19,14,224
LGA14350,41,15,12,5,73,886,471,197,129,1683
LGA14400,13,0,4,0,17,417,210,66,30,723
LGA14450,29,12,4,0,45,1330,586,166,57,2139
LGA14500,28,11,5,0,44,1657,990,269,64,2980
LGA14550,8,5,0,0,13,264,119,50,22,455
LGA14600,9,7,4,0,20,153,66,46,14,279
LGA14650,158,61,23,12,254,5184,2717,946,354,9201
LGA14700,6,4,0,3,13,630,236,67,13,946
LGA14750,12,4,4,0,20,219,153,62,33,467
LGA14800,17,3,3,0,23,1182,406,76,26,1690
LGA14850,34,16,8,9,67,1390,641,243,103,2377
LGA14870,14,7,4,0,25,556,263,88,55,962
LGA14900,171,88,38,10,307,4191,2710,1078,499,8478
LGA14920,6,4,0,0,10,205,85,43,18,351
LGA14950,3,0,0,0,3,61,20,9,0,90
LGA15050,53,22,14,9,98,1687,994,343,172,3196
LGA15150,14,4,0,0,18,691,317,92,13,1113
LGA15200,42,18,5,0,65,1945,753,178,73,2949
LGA15270,22,10,3,0,35,536,235,95,39,905
LGA15300,21,13,4,11,49,335,185,71,59,650
LGA15350,4,0,0,0,4,490,205,65,9,769
LGA15500,0,6,0,4,10,116,71,22,8,217
LGA15550,4,0,0,0,4,52,31,13,8,104
LGA15650,10,8,3,4,25,353,179,80,50,662
LGA15700,17,8,3,3,31,524,279,117,74,994
LGA15750,13,11,3,3,30,270,151,70,36,527
LGA15800,9,3,3,0,15,151,59,36,19,265
LGA15850,11,8,0,0,19,176,88,53,33,350
LGA15900,131,34,20,7,192,4266,1967,576,214,7023
LGA15950,16,5,0,0,21,1072,367,52,7,1498
LGA16100,3,3,0,0,6,93,45,29,14,181
LGA16150,39,17,13,10,79,976,492,208,121,1797
LGA16180,7,5,0,0,12,198,114,33,18,363
LGA16200,19,4,0,4,27,384,193,78,42,697
LGA16250,116,47,20,9,192,3819,1812,635,311,6577
LGA16350,174,73,28,16,291,5022,2765,1044,462,9293
LGA16370,21,14,0,3,38,1105,580,166,34,1885
LGA16380,56,20,4,6,86,1895,1017,324,126,3362
LGA16400,53,22,13,3,91,1629,884,335,133,2981
LGA16470,28,12,8,3,51,936,475,158,59,1628
LGA16550,93,17,3,3,116,2970,1226,282,69,4547
LGA16610,29,6,6,5,46,596,360,141,73,1170
LGA16650,60,17,13,5,95,2459,1090,342,140,4031
LGA16700,42,19,4,0,65,2295,1002,232,47,3576
LGA16900,61,25,7,10,103,1785,1024,368,172,3349
LGA16950,88,30,8,8,134,2442,1303,464,202,4411
LGA17000,14,12,0,0,26,436,253,104,42,835
LGA17050,3,0,0,0,3,116,53,17,0,186
LGA17100,10,8,3,3,24,784,380,100,29,1293
LGA17150,90,41,8,6,145,4531,2392,714,187,7824
LGA17200,67,28,10,5,110,2661,865,197,69,3792
LGA17310,59,20,4,10,93,1548,793,315,180,2836
LGA17350,3,0,0,0,3,127,59,25,16,227
LGA17400,5,3,0,0,8,158,68,45,21,292
LGA17420,40,31,11,0,82,2686,1613,533,122,4954
LGA17450,0,3,0,0,3,52,36,13,3,104
LGA17500,9,3,0,3,15,243,124,47,22,436
LGA17550,63,37,6,6,112,2476,1261,419,167,4323
LGA17620,12,5,0,3,20,277,166,56,21,520
LGA17640,5,3,0,0,8,146,75,23,0,244
LGA17650,3,0,0,0,3,118,54,32,17,221
LGA17700,3,0,0,0,3,17,10,6,0,33
LGA17750,41,19,13,13,86,1419,756,305,162,2642
LGA17800,5,7,0,0,12,60,31,15,6,112
LGA17850,0,0,4,0,4,58,17,17,7,99
LGA17900,14,10,9,3,36,190,79,39,36,344
LGA17950,3,5,3,0,11,66,31,9,15,121
LGA18000,83,30,4,3,120,2864,1434,362,87,4747
LGA18020,16,7,0,0,23,206,111,45,26,388
LGA18050,16,14,4,0,34,1156,464,108,22,1750
LGA18100,0,0,0,0,0,85,39,12,6,142
LGA18150,17,3,0,0,20,229,126,45,38,438
LGA18200,9,0,4,0,13,146,62,37,9,254
LGA18250,21,5,3,0,29,1426,631,136,28,2221
LGA18350,26,14,5,0,45,1029,541,178,85,1833
LGA18400,30,11,8,3,52,833,483,202,96,1614
LGA18450,156,70,20,7,253,5032,2726,868,320,8946
LGA18500,15,4,4,0,23,929,399,102,15,1445
LGA18550,142,64,38,12,256,4686,2566,985,444,8681
LGA18710,5,0,0,0,5,253,123,44,16,436
LGA18750,14,4,0,0,18,304,147,77,30,558
LGA19399,3,0,0,0,3,16,12,0,0,28
LGA20110,6,3,0,0,9,221,130,29,12,392
LGA20260,12,0,0,0,12,252,122,53,16,443
LGA20570,67,35,15,15,132,2486,1309,513,217,4525
LGA20660,78,41,10,6,135,2997,1434,454,137,5022
LGA20740,18,9,0,0,27,686,329,112,34,1161
LGA20830,36,18,9,6,69,952,523,204,77,1756
LGA20910,45,21,3,0,69,1926,960,256,52,3194
LGA21010,4,4,0,3,11,344,170,74,27,615
LGA21110,57,22,4,3,86,2810,1433,383,71,4697
LGA21180,194,117,61,32,404,4927,2993,1151,510,9581
LGA21270,4,0,0,0,4,102,54,9,7,172
LGA21370,27,13,3,0,43,838,436,198,68,1540
LGA21450,47,23,12,3,85,1510,939,376,138,2963
LGA21610,190,105,26,24,345,5489,3586,1340,572,10987
LGA21670,14,8,5,0,27,350,152,83,27,612
LGA21750,13,9,4,0,26,447,207,101,39,794
LGA21830,15,6,5,0,26,337,156,64,31,588
LGA21890,137,37,12,6,192,3539,1450,406,139,5534
LGA22110,40,18,6,4,68,941,510,188,77,1716
LGA22170,125,58,22,8,213,3908,2118,704,236,6966
LGA22250,9,3,0,0,12,212,89,40,14,355
LGA22310,50,24,11,3,88,2703,1164,307,68,4242
LGA22410,14,9,4,3,30,470,231,95,28,824
LGA22490,11,6,0,0,17,304,149,58,28,539
LGA22620,69,40,18,12,139,2727,1424,507,215,4873
LGA22670,122,79,16,31,248,3835,2000,621,355,6811
LGA22750,169,75,25,18,287,5391,2987,1014,370,9762
LGA22830,69,20,23,4,116,1385,812,357,154,2708
LGA22910,11,3,5,0,19,380,184,59,17,640
LGA22980,0,0,0,0,0,121,46,25,11,203
LGA23110,65,29,9,3,106,2255,1054,334,80,3723
LGA23190,16,5,4,3,28,459,216,87,41,803
LGA23270,133,78,31,29,271,3985,2554,1008,480,8027
LGA23350,4,5,0,0,9,300,162,46,29,537
LGA23430,94,27,10,11,142,3490,1698,456,118,5762
LGA23670,89,48,17,7,161,3394,2033,624,190,6241
LGA23810,76,25,13,12,126,2010,1062,398,200,3670
LGA23940,4,3,4,0,11,148,52,30,13,243
LGA24130,24,3,0,0,27,700,458,177,64,1399
LGA24210,41,15,4,0,60,2251,1173,324,85,3833
LGA24250,5,0,0,0,5,163,76,25,8,272
LGA24330,46,16,6,10,78,1763,876,234,111,2984
LGA24410,74,30,7,4,115,2676,1426,436,130,4668
LGA24600,32,11,12,6,61,1307,457,113,42,1919
LGA24650,77,53,14,14,158,2359,1647,627,284,4917
LGA24780,56,30,18,10,114,1244,766,303,136,2449
LGA24850,34,17,8,3,62,806,476,190,64,1536
LGA24900,25,5,0,3,33,578,283,115,60,1036
LGA24970,96,28,12,8,144,3711,1794,433,122,6060
LGA25060,91,28,16,7,142,2474,1296,329,84,4183
LGA25150,26,12,4,3,45,660,370,126,42,1198
LGA25250,103,36,15,7,161,3566,1471,415,163,5615
LGA25340,92,49,14,11,166,3335,1887,645,184,6051
LGA25430,12,3,4,0,19,491,210,62,25,788
LGA25490,6,3,4,0,13,292,159,69,18,538
LGA25620,12,3,3,0,18,232,134,44,10,420
LGA25710,20,10,3,0,33,987,695,207,52,1941
LGA25810,11,6,0,0,17,277,131,40,16,464
LGA25900,21,15,5,0,41,1737,599,121,27,2484
LGA25990,4,3,3,0,10,149,68,22,9,248
LGA26080,3,3,0,0,6,50,19,7,4,80
LGA26170,8,14,3,3,28,531,271,125,39,966
LGA26260,16,4,0,0,20,337,134,60,17,548
LGA26350,34,9,3,3,49,1536,666,169,41,2412
LGA26430,6,5,0,0,11,221,89,29,21,360
LGA26490,12,0,0,0,12,453,257,94,17,821
LGA26610,20,8,3,8,39,396,228,100,53,777
LGA26670,3,0,0,0,3,103,58,8,9,178
LGA26700,22,10,4,0,36,643,331,126,41,1141
LGA26730,22,11,3,3,39,811,423,150,64,1448
LGA26810,32,11,8,3,54,851,513,215,74,1653
LGA26890,0,0,0,0,0,76,20,12,10,118
LGA26980,73,15,4,0,92,3489,1646,401,113,5649
LGA27070,113,71,28,9,221,3566,2206,811,269,6852
LGA27170,22,15,16,0,53,969,562,202,79,1812
LGA27260,105,38,22,31,196,3543,2260,854,373,7030
LGA27350,32,19,6,9,66,1607,655,160,81,2503
LGA27450,87,38,17,3,145,3310,1951,661,196,6118
LGA27630,9,0,0,0,9,136,64,18,13,231
LGA29399,0,0,0,0,0,3,3,0,3,9
LGA30250,10,0,5,0,15,56,18,16,18,108
LGA30300,7,0,0,0,7,76,53,18,17,164
LGA30370,16,7,0,0,23,262,118,41,19,440
LGA30410,3,0,0,0,3,67,23,6,6,102
LGA30450,0,0,0,0,0,4,6,0,0,10
LGA30760,3,3,0,0,6,45,16,3,0,64
LGA30900,0,0,0,0,0,12,0,0,0,12
LGA31000,524,244,67,44,879,23257,11242,3313,1237,39049
LGA31750,0,0,0,0,0,3,3,0,0,6
LGA31820,70,43,10,13,136,2280,1210,482,246,4218
LGA31900,16,9,3,6,34,360,170,83,46,659
LGA31950,0,0,0,0,0,3,4,0,3,10
LGA32070,149,79,43,34,305,4192,2218,837,450,7697
LGA32250,0,0,4,3,7,35,11,11,10,67
LGA32260,30,11,9,3,53,650,321,119,72,1162
LGA32270,14,10,0,3,27,347,192,66,35,640
LGA32310,15,5,3,0,23,275,144,56,37,512
LGA32330,0,0,0,0,0,48,24,12,20,104
LGA32450,0,0,0,3,3,52,20,9,11,92
LGA32500,4,3,3,0,10,80,51,15,8,154
LGA32600,5,0,0,0,5,5,5,0,4,14
LGA32750,0,0,0,0,0,3,0,0,0,3
LGA32770,0,3,0,3,6,24,21,14,9,68
LGA33100,0,0,0,0,0,8,3,0,6,17
LGA33200,6,0,3,0,9,31,7,9,0,47
LGA33220,92,50,16,13,171,2555,1297,545,258,4655
LGA33360,35,22,8,5,70,1084,537,230,89,1940
LGA33430,307,136,47,7,497,13212,6593,1973,644,22422
LGA33610,7,12,0,0,19,180,108,40,22,350
LGA33620,45,17,11,9,82,1086,586,250,129,2051
LGA33800,10,3,0,0,13,225,102,30,17,374
LGA33830,0,0,0,0,0,33,23,8,9,73
LGA33960,121,71,22,32,246,4546,2598,1067,586,8797
LGA33980,12,7,0,3,22,246,131,41,24,442
LGA34420,3,0,0,0,3,48,25,12,4,89
LGA34570,0,0,0,0,0,11,16,3,3,33
LGA34580,35,15,10,3,63,778,418,175,100,1471
LGA34590,268,128,49,52,497,7759,4213,1694,908,14574
LGA34710,0,4,3,0,7,83,38,29,8,158
LGA34770,81,41,9,3,134,2239,1120,453,175,3987
LGA34800,4,0,0,0,4,14,4,4,0,22
LGA34830,0,0,0,0,0,15,3,0,0,18
LGA34860,7,3,0,5,15,241,115,39,8,403
LGA35010,273,136,81,28,518,9376,5280,1888,828,17372
LGA35250,0,4,0,0,4,30,22,15,16,83
LGA35300,32,3,8,0,43,380,196,100,71,747
LGA35600,4,0,0,0,4,90,37,20,12,159
LGA35670,0,0,0,0,0,35,20,8,15,78
LGA35760,11,6,0,0,17,198,87,47,24,356
LGA35780,3,0,3,3,9,67,36,25,25,153
LGA35790,0,0,0,0,0,72,41,32,30,175
LGA35800,3,3,3,3,12,44,16,12,12,84
LGA36070,0,0,0,0,0,26,14,0,6,46
LGA36150,3,0,0,0,3,34,6,6,0,46
LGA36250,77,35,9,10,131,3195,1758,577,247,5777
LGA36300,3,0,0,0,3,18,6,0,3,27
LGA36360,113,40,18,13,184,2688,1358,558,240,4844
LGA36510,20,8,5,3,36,795,412,162,73,1442
LGA36580,18,5,5,0,28,481,256,117,50,904
LGA36630,36,15,4,5,60,727,347,153,110,1337
LGA36660,28,22,4,4,58,773,378,170,83,1404
LGA36710,194,82,32,8,316,7678,3976,1284,431,13369
LGA36810,50,24,13,3,90,1086,513,234,113,1946
LGA36910,92,38,15,9,154,3371,1774,695,367,6207
LGA36950,10,4,4,3,21,68,39,38,22,167
LGA36960,3,3,0,0,6,148,82,40,39,309
LGA37010,124,72,29,18,243,4117,2272,828,430,7647
LGA37300,7,0,0,0,7,52,23,11,3,89
LGA37310,24,16,8,0,48,567,286,121,76,1050
LGA37340,29,16,3,0,48,621,285,97,55,1058
LGA37400,3,0,0,0,3,27,10,9,0,46
LGA37550,0,0,0,0,0,28,24,15,22,89
LGA37570,0,0,0,0,0,11,3,3,6,23
LGA37600,0,0,0,0,0,98,64,37,37,236
LGA39399,0,0,0,0,0,0,0,0,0,0
LGA40070,7,4,0,0,11,259,79,15,3,356
LGA40120,13,3,3,3,22,616,366,112,29,1123
LGA40220,14,4,0,0,18,484,281,89,19,873
LGA40250,3,0,3,0,6,82,36,20,16,154
LGA40310,6,0,3,0,9,392,180,93,25,690
LGA40430,0,0,0,0,0,40,15,6,6,67
LGA40520,17,8,0,0,25,304,139,50,36,529
LGA40700,11,6,0,0,17,814,423,103,25,1365
LGA40910,16,9,7,3,35,1149,629,187,43,2008
LGA41010,0,0,0,0,0,67,44,13,11,135
LGA41060,70,35,5,3,113,2974,1346,433,167,4920
LGA41140,6,0,3,3,12,123,88,31,15,257
LGA41190,0,0,3,0,3,22,13,3,0,38
LGA41330,6,3,0,0,9,25,15,6,6,52
LGA41560,17,4,4,0,25,305,166,56,22,549
LGA41750,0,0,0,0,0,15,6,6,0,27
LGA41830,0,0,3,0,3,40,21,13,0,74
LGA41960,0,0,0,0,0,9,6,5,7,27
LGA42030,14,7,0,0,21,580,386,111,38,1115
LGA42110,4,0,0,3,7,96,39,15,11,161
LGA42250,8,0,0,0,8,106,57,23,3,189
LGA42600,10,7,0,0,17,817,295,53,20,1185
LGA42750,0,0,0,0,0,68,40,10,0,118
LGA43080,0,0,0,0,0,13,8,3,0,24
LGA43220,0,0,0,0,0,12,6,0,0,18
LGA43360,6,0,0,0,6,49,15,6,3,73
LGA43650,7,0,0,0,7,226,119,57,20,422
LGA43710,0,0,0,0,0,64,43,14,3,124
LGA43790,9,3,3,3,18,223,130,36,24,413
LGA43920,0,0,0,0,0,164,87,30,9,290
LGA44000,0,0,0,0,0,0,4,0,0,4
LGA44060,58,8,9,3,78,2366,1081,289,91,3827
LGA44210,9,0,0,0,9,166,74,32,14,286
LGA44340,20,4,0,0,24,1224,682,190,35,2131
LGA44550,7,7,4,3,21,650,415,117,33,1215
LGA44620,24,12,4,3,43,739,424,125,61,1349
LGA44830,7,0,0,0,7,44,11,9,4,68
LGA45040,16,9,4,9,38,515,282,83,69,949
LGA45090,6,0,0,0,6,139,56,27,5,227
LGA45120,0,0,0,0,0,69,37,15,3,124
LGA45290,21,7,0,3,31,856,339,79,19,1293
LGA45340,86,51,18,7,162,4427,2455,788,267,7937
LGA45400,0,0,0,0,0,18,9,0,0,27
LGA45540,0,0,0,0,0,53,28,12,6,99
LGA45680,102,66,30,23,221,2817,1592,665,342,5416
LGA45890,101,56,20,15,192,3511,1718,566,256,6051
LGA46090,12,8,4,5,29,365,189,93,41,688
LGA46300,14,5,6,0,25,403,200,58,38,699
LGA46450,16,4,3,3,26,462,242,107,48,859
LGA46510,10,3,0,0,13,439,175,52,20,686
LGA46670,4,9,0,0,13,193,127,44,17,381
LGA46860,4,0,0,0,4,20,8,3,0,31
LGA46970,0,0,0,0,0,38,15,7,3,63
LGA47140,92,62,28,21,203,3856,2201,756,342,7155
LGA47290,0,0,0,0,0,34,13,9,0,56
LGA47490,3,0,0,0,3,32,10,6,6,54
LGA47630,3,3,3,0,9,98,51,21,16,186
LGA47700,44,21,4,3,72,2288,1286,434,101,4109
LGA47800,0,3,0,0,3,109,54,13,9,185
LGA47910,0,3,0,0,3,39,15,7,6,67
LGA47980,12,0,0,0,12,730,321,91,12,1154
LGA48050,10,3,0,3,16,278,119,56,24,477
LGA48130,7,0,3,0,10,131,71,35,15,252
LGA48260,5,0,0,0,5,124,57,12,7,200
LGA48340,9,0,4,0,13,259,114,50,23,446
LGA48410,18,3,4,3,28,1367,576,143,46,2132
LGA48540,33,8,6,3,50,687,322,124,71,1204
LGA48640,0,0,0,0,0,9,6,3,0,18
LGA48750,5,0,0,0,5,98,34,18,9,159
LGA48830,6,0,3,3,12,183,93,29,20,325
LGA49399,10,3,4,3,20,64,32,15,6,117
LGA50080,20,7,0,7,34,734,419,122,58,1333
LGA50210,49,25,10,7,91,1676,922,318,148,3064
LGA50250,4,3,0,3,10,74,45,18,12,149
LGA50280,5,4,0,0,9,224,144,43,3,414
LGA50350,13,5,0,0,18,430,215,51,25,721
LGA50420,51,10,3,4,68,1568,662,185,66,2481
LGA50490,27,14,15,5,61,950,403,141,80,1574
LGA50560,0,0,0,0,0,29,10,3,0,42
LGA50630,0,0,0,3,3,27,12,0,9,48
LGA50770,0,0,0,0,0,21,10,6,3,40
LGA50840,0,3,5,0,8,73,53,22,3,151
LGA50910,0,0,0,0,0,9,9,0,0,18
LGA50980,18,13,0,9,40,332,210,84,50,676
LGA51080,3,0,3,0,6,18,6,12,6,42
LGA51120,0,0,0,0,0,21,0,0,3,24
LGA51190,24,12,6,0,42,886,443,166,53,1548
LGA51260,16,9,0,0,25,624,371,120,38,1153
LGA51310,4,0,0,0,4,319,190,63,13,585
LGA51330,32,16,10,8,66,1773,913,316,89,3091
LGA51400,5,3,0,0,8,238,181,58,19,496
LGA51470,0,0,0,0,0,7,3,3,0,13
LGA51540,12,6,3,4,25,122,58,31,23,234
LGA51610,0,0,0,0,0,12,6,6,3,27
LGA51680,4,0,0,0,4,49,33,20,4,106
LGA51750,3,0,0,0,3,180,97,27,6,310
LGA51820,59,21,15,3,98,2076,1121,355,143,3695
LGA51890,10,8,0,0,18,188,109,31,25,353
LGA51960,4,0,0,5,9,77,34,27,9,147
LGA52030,3,0,0,0,3,18,3,3,3,27
LGA52100,0,0,0,0,0,13,4,6,3,26
LGA52170,0,0,0,0,0,114,50,25,0,189
LGA52240,0,0,0,0,0,19,10,9,0,38
LGA52310,0,0,0,0,0,19,0,0,0,19
LGA52380,0,3,0,0,3,3,6,3,0,12
LGA52450,0,0,0,0,0,24,7,6,0,37
LGA52520,0,0,0,0,0,21,3,3,3,30
LGA52590,0,0,0,0,0,41,25,9,6,81
LGA52660,4,0,0,0,4,218,161,57,9,445
LGA52730,3,0,0,0,3,110,75,29,0,214
LGA52800,3,8,3,3,17,172,104,64,43,383
LGA52870,0,3,0,0,3,100,51,16,4,171
LGA52940,0,0,0,0,0,8,5,0,3,16
LGA53010,0,0,0,0,0,12,0,0,0,12
LGA53080,3,3,3,0,9,28,12,7,3,50
LGA53150,3,0,0,0,3,129,52,21,9,211
LGA53220,3,5,3,3,14,87,43,17,18,165
LGA53290,12,5,0,0,17,274,156,33,35,498
LGA53360,4,0,0,0,4,44,12,3,3,62
LGA53430,12,5,4,0,21,727,330,83,28,1168
LGA53520,29,22,11,13,75,833,527,199,100,1659
LGA53570,0,0,0,0,0,58,37,15,9,119
LGA53640,0,0,0,0,0,17,12,8,0,37
LGA53710,3,0,0,0,3,6,12,0,9,27
LGA53780,68,40,17,13,138,2546,1408,511,225,4690
LGA53920,3,0,3,0,6,92,56,39,38,225
LGA53990,14,6,6,5,31,420,263,102,38,823
LGA54060,3,3,0,3,9,48,38,15,9,110
LGA54130,0,0,0,0,0,9,9,0,0,18
LGA54170,45,17,9,0,71,2966,1751,531,137,5385
LGA54200,20,9,6,0,35,1088,702,222,78,2090
LGA54280,33,17,8,4,62,562,291,116,51,1020
LGA54340,4,3,0,4,11,74,44,24,20,162
LGA54410,0,0,0,0,0,24,10,0,3,37
LGA54480,0,0,0,0,0,6,3,0,0,9
LGA54550,0,0,0,0,0,34,16,11,0,61
LGA54620,3,0,0,0,3,9,9,0,0,18
LGA54690,0,0,0,0,0,9,6,0,0,15
LGA54760,0,0,0,0,0,6,0,0,3,9
LGA54830,33,11,3,4,51,796,458,161,60,1475
LGA54900,0,0,3,0,3,12,6,6,3,27
LGA54970,0,3,0,0,3,18,15,0,0,33
LGA55040,0,3,3,0,6,15,18,3,0,36
LGA55110,54,17,14,8,93,1691,917,378,155,3141
LGA55180,4,3,0,0,7,200,104,30,21,355
LGA55250,3,3,3,3,12,21,9,9,6,45
LGA55320,39,6,7,0,52,1900,1053,278,65,3296
LGA55390,0,0,0,0,0,9,7,3,3,22
LGA55460,3,3,3,0,9,54,26,12,4,96
LGA55530,0,3,0,0,3,6,9,6,0,21
LGA55600,3,0,0,0,3,55,24,10,3,92
LGA55670,3,0,0,0,3,17,12,0,3,32
LGA55740,0,3,0,0,3,146,92,31,10,279
LGA55810,3,0,0,0,3,10,5,4,3,22
LGA55880,0,0,0,0,0,3,4,0,0,7
LGA55950,0,0,0,0,0,6,3,0,0,9
LGA56020,0,3,3,0,6,13,6,8,3,30
LGA56090,17,11,4,0,32,720,390,161,56,1327
LGA56160,3,0,0,0,3,6,0,0,0,6
LGA56230,13,3,0,3,19,268,150,70,25,513
LGA56300,3,3,0,0,6,23,13,6,6,48
LGA56370,0,0,0,0,0,12,6,0,3,21
LGA56450,0,0,0,0,0,11,7,0,0,18
LGA56520,9,0,0,0,9,108,45,15,13,181
LGA56580,3,3,0,0,6,288,183,70,10,551
LGA56620,3,3,0,0,6,50,35,13,7,105
LGA56730,6,5,0,3,14,246,140,48,39,473
LGA56790,0,0,0,0,0,55,31,12,3,101
LGA56860,0,0,0,0,0,3,3,0,3,9
LGA56930,3,0,0,0,3,20,19,3,0,42
LGA57000,0,0,0,0,0,9,0,3,0,12
LGA57080,5,0,0,0,5,172,35,6,0,213
LGA57140,0,0,0,3,3,29,9,6,12,56
LGA57210,4,0,0,0,4,113,45,27,9,194
LGA57280,14,8,4,3,29,181,88,36,28,333
LGA57350,0,3,0,0,3,15,12,3,6,36
LGA57420,0,3,0,0,3,19,12,6,3,40
LGA57490,82,28,10,4,124,2286,1329,504,220,4339
LGA57560,10,6,6,0,22,221,100,49,25,395
LGA57630,0,0,0,0,0,0,0,0,0,0
LGA57700,10,3,0,0,13,280,175,80,26,561
LGA57770,0,0,0,0,0,17,3,0,4,24
LGA57840,17,3,4,3,27,816,341,97,34,1288
LGA57910,101,68,28,21,218,4631,2162,583,241,7617
LGA57980,0,0,0,0,0,285,118,33,9,445
LGA58050,75,36,27,17,155,2578,1527,565,267,4937
LGA58190,0,3,0,0,3,7,3,3,0,13
LGA58260,0,0,0,0,0,10,12,0,0,22
LGA58330,0,3,0,0,3,88,55,11,12,166
LGA58400,0,0,0,0,0,3,4,3,3,13
LGA58470,0,6,0,0,6,7,6,6,0,19
LGA58510,17,10,0,5,32,671,262,60,26,1019
LGA58540,0,0,0,0,0,6,3,6,0,15
LGA58570,8,3,0,0,11,567,206,51,7,831
LGA58610,5,0,0,0,5,37,15,9,3,64
LGA58680,0,0,0,0,0,4,3,0,0,7
LGA58760,88,31,21,21,161,3184,1972,719,353,6228
LGA58820,3,0,0,0,3,78,36,21,9,144
LGA58890,0,0,0,0,0,9,3,3,3,18
LGA59030,0,0,0,0,0,0,3,0,0,3
LGA59100,0,3,0,0,3,23,12,0,3,38
LGA59170,0,0,0,0,0,18,6,3,0,27
LGA59250,0,0,0,0,0,15,13,4,3,35
LGA59310,0,0,0,0,0,17,16,10,3,46
LGA59320,0,0,0,0,0,12,3,0,3,18
LGA59330,0,0,0,0,0,12,4,0,0,16
LGA59340,8,5,5,3,21,158,74,51,51,334
LGA59350,0,0,0,0,0,0,3,3,3,9
LGA59360,3,0,0,0,3,31,8,0,6,45
LGA59370,4,0,0,0,4,77,32,8,12,129
LGA59399,0,0,0,0,0,0,0,0,0,0
LGA60210,0,5,0,0,5,149,66,22,12,249
LGA60410,26,10,3,3,42,544,336,121,73,1074
LGA60610,12,6,3,3,24,540,309,107,52,1008
LGA60810,14,3,3,3,23,505,258,109,33,905
LGA61010,0,0,0,3,3,48,16,10,6,80
LGA61210,0,3,3,0,6,154,80,37,9,280
LGA61410,32,15,3,6,56,1412,791,232,101,2536
LGA61510,8,6,0,0,14,241,126,58,16,441
LGA61610,26,10,3,3,42,754,381,152,62,1349
LGA61810,0,3,0,3,6,138,72,30,9,249
LGA62010,0,0,0,0,0,12,5,0,3,20
LGA62210,10,7,0,3,20,205,93,35,27,360
LGA62410,6,0,0,0,6,74,30,11,9,124
LGA62610,54,32,10,3,99,1617,790,266,129,2802
LGA62810,20,5,3,0,28,1078,458,125,39,1700
LGA63010,15,4,3,0,22,368,171,64,22,625
LGA63210,0,3,0,0,3,139,67,24,15,245
LGA63410,6,0,0,0,6,35,10,6,0,51
LGA63610,13,3,0,3,19,753,445,142,50,1390
LGA63810,4,3,0,0,7,217,109,39,17,382
LGA64010,48,25,12,5,90,1862,950,356,117,3285
LGA64210,9,3,3,0,15,370,199,62,28,659
LGA64610,11,0,3,0,14,273,121,41,23,458
LGA64810,5,4,3,3,15,371,190,72,20,653
LGA65010,3,3,0,0,6,136,57,20,15,228
LGA65210,0,0,3,0,3,57,17,6,0,80
LGA65410,11,4,3,3,21,333,158,58,39,588
LGA65610,4,3,0,0,7,116,48,17,10,191
LGA65810,6,5,3,0,14,460,236,82,32,810
LGA69399,0,0,0,0,0,0,0,0,0,0
LGA70200,35,18,10,6,69,555,276,127,65,1023
LGA70420,17,14,8,10,49,150,88,53,51,342
LGA70540,0,0,0,0,0,6,9,4,3,22
LGA70620,7,4,0,0,11,81,54,31,24,190
LGA70700,0,0,0,0,0,24,15,11,3,53
LGA71000,69,25,14,6,114,1544,753,285,139,2721
LGA71300,3,3,0,3,9,253,168,84,103,608
LGA72200,7,3,8,3,21,198,84,50,34,366
LGA72300,3,6,3,3,15,311,185,61,20,577
LGA72330,15,7,4,0,26,138,100,42,29,309
LGA72800,15,5,4,3,27,631,387,176,70,1264
LGA73600,8,4,0,0,12,126,75,50,52,303
LGA74050,0,0,0,0,0,59,27,16,15,117
LGA74500,0,0,0,3,3,99,81,55,57,292
LGA74560,0,4,0,0,4,4,8,0,0,12
LGA74660,3,3,0,3,9,130,84,38,38,290
LGA79399,5,3,0,0,8,78,32,8,6,124
LGA89399,105,63,21,13,202,7631,4295,1269,406,13601
LGA99399,0,0,0,0,0,36,27,6,3,72
