region_id,C11_T_FH_Tot,C11_Tot_LP_H,C11_Tot_GH,C11_Tot_OH,C11_T_T
LGA10050,12204,5581,830,785,19400
LGA10110,5689,2467,430,546,9132
LGA10150,10094,4180,1022,891,16187
LGA10200,17194,3759,1123,1375,23451
LGA10250,10777,4260,558,775,16370
LGA10300,595,223,14,98,930
LGA10350,44618,11454,1166,2447,59685
LGA10470,9551,3549,553,667,14320
LGA10550,8876,3464,339,758,13437
LGA10600,3462,1380,168,229,5239
LGA10650,2165,1029,55,132,3381
LGA10750,76471,15098,2090,2743,96402
LGA10800,1568,646,47,103,2364
LGA10850,1832,679,39,112,2662
LGA10900,20051,7185,799,1340,29375
LGA10950,716,317,19,115,1167
LGA11000,652,331,21,34,1038
LGA11050,630,319,15,36,1000
LGA11100,9975,3464,681,765,14885
LGA11150,627,283,23,274,1207
LGA11200,389,170,19,52,630
LGA11250,4781,2507,149,618,8055
LGA11300,7653,2211,862,513,11239
LGA11350,7274,3089,836,1204,12403
LGA11400,3528,1109,71,118,4826
LGA11450,14963,2591,322,532,18408
LGA11500,37381,8856,1050,1793,49080
LGA11520,20076,6458,1484,1718,29736
LGA11550,34636,9746,1545,2535,48462
LGA11600,677,281,30,68,1056
LGA11700,456,265,17,156,894
LGA11720,13418,4343,468,769,18998
LGA11730,13409,5326,524,1239,20498
LGA11750,1159,525,38,241,1963
LGA11800,18237,6932,901,1545,27615
LGA11860,421,118,11,28,578
LGA12000,1082,374,32,66,1554
LGA12050,2574,1168,88,186,4016
LGA12150,1045,459,31,107,1642
LGA12200,2011,894,44,111,3060
LGA12300,3032,1259,117,204,4612
LGA12350,3168,1460,113,321,5062
LGA12500,1872,983,63,172,3090
LGA12600,9993,3601,443,626,14663
LGA12700,2327,743,50,125,3245
LGA12750,9846,4159,335,998,15338
LGA12850,45959,8736,1143,1828,57666
LGA12900,2407,1077,77,141,3702
LGA12950,1164,456,30,99,1749
LGA13010,2307,1070,91,161,3629
LGA13050,1373,589,36,87,2085
LGA13100,42885,16703,1707,2617,63912
LGA13310,7159,3035,260,432,10886
LGA13320,9605,4340,359,972,15276
LGA13340,2622,917,77,166,3782
LGA13380,12669,5009,482,780,18940
LGA13450,6183,2060,208,506,8957
LGA13500,998,378,29,47,1452
LGA13550,3135,1232,118,268,4753
LGA13650,1140,434,36,74,1684
LGA13660,1376,609,33,56,2074
LGA13700,970,430,36,49,1485
LGA13800,16087,4260,496,900,21743
LGA13850,776,366,23,90,1255
LGA13950,25225,6902,885,1602,34614
LGA14000,42195,9342,1134,1285,53956
LGA14100,3228,1162,98,148,4636
LGA14150,20698,5869,979,862,28408
LGA14200,4271,1673,140,211,6295
LGA14250,385,154,11,32,582
LGA14300,1349,507,34,89,1979
LGA14350,7341,2989,285,761,11376
LGA14400,5650,1646,115,267,7678
LGA14450,14740,3882,732,663,20017
LGA14500,29472,5813,494,1162,36941
LGA14550,2453,1055,87,165,3760
LGA14600,1733,696,47,134,2610
LGA14650,52074,16829,1650,1746,72299
LGA14700,8256,3025,602,453,12336
LGA14750,2695,1004,88,250,4037
LGA14800,13390,6291,1638,1318,22637
LGA14850,11045,4487,811,616,16959
LGA14870,5221,2392,175,330,8118
LGA14900,44018,8595,977,2880,56470
LGA14920,2038,835,80,96,3049
LGA14950,805,301,23,29,1158
LGA15050,18342,5185,571,737,24835
LGA15150,10383,3832,919,1121,16255
LGA15200,18110,8772,3092,2124,32098
LGA15270,5874,2272,217,566,8929
LGA15300,3235,1313,114,555,5217
LGA15350,6992,3406,347,905,11650
LGA15500,1903,744,59,163,2869
LGA15550,594,225,16,41,876
LGA15650,3936,1418,182,461,5997
LGA15700,4999,2385,232,376,7992
LGA15750,3392,1278,111,343,5124
LGA15800,1490,715,42,146,2393
LGA15850,1706,689,56,96,2547
LGA15900,37308,17266,3879,2428,60881
LGA15950,15558,10689,2178,2942,31367
LGA16100,1352,506,31,81,1970
LGA16150,9528,3880,455,781,14644
LGA16180,3842,923,83,357,5205
LGA16200,3736,1564,107,385,5792
LGA16250,41169,13159,2376,3065,59769
LGA16350,46494,11419,1477,2111,61501
LGA16370,15423,3873,478,816,20590
LGA16380,20281,8017,765,1394,30457
LGA16400,17543,5889,547,1254,25233
LGA16470,9808,3885,416,786,14895
LGA16550,29882,12995,4685,3729,51291
LGA16610,5877,2379,205,555,9016
LGA16650,24710,8196,1502,1949,36357
LGA16700,26167,9503,2005,1481,39156
LGA16900,17415,4640,380,566,23001
LGA16950,25104,9962,869,1817,37752
LGA17000,5954,1603,202,404,8163
LGA17050,1634,624,108,1312,3678
LGA17100,8617,2150,611,804,12182
LGA17150,57169,16308,1869,2442,77788
LGA17200,33590,29228,10354,11978,85150
LGA17310,14944,5609,588,869,22010
LGA17350,1541,710,43,62,2356
LGA17400,1765,856,60,185,2866
LGA17420,46023,6393,872,1205,54493
LGA17450,886,385,19,50,1340
LGA17500,2925,1198,75,215,4413
LGA17550,22819,9570,1267,2223,35879
LGA17620,3661,1428,159,266,5514
LGA17640,1994,773,28,117,2912
LGA17650,1644,515,42,75,2276
LGA17700,306,131,6,24,467
LGA17750,15184,5535,997,628,22344
LGA17800,1078,407,25,132,1642
LGA17850,858,346,12,49,1265
LGA17900,1462,942,90,427,2921
LGA17950,739,342,25,45,1151
LGA18000,37245,11574,1820,1799,52438
LGA18020,2480,1091,92,236,3899
LGA18050,14513,7576,2778,3159,28026
LGA18100,1032,437,32,43,1544
LGA18150,2105,896,62,153,3216
LGA18200,1784,631,49,270,2734
LGA18250,17756,5706,1233,1300,25995
LGA18350,12054,4325,315,642,17336
LGA18400,11470,2245,237,419,14371
LGA18450,50151,18585,3027,2637,74400
LGA18500,12363,6541,1557,2469,22930
LGA18550,39722,14662,1528,1944,57856
LGA18710,4092,991,98,248,5429
LGA18750,3173,1297,100,211,4781
LGA19399,263,112,9,83,467
LGA20110,3207,1424,109,406,5146
LGA20260,2918,1305,115,153,4491
LGA20570,23695,10239,1811,1314,37059
LGA20660,31656,10442,1599,1242,44939
LGA20740,7743,3734,379,1170,13026
LGA20830,11648,3978,359,503,16488
LGA20910,24486,8011,774,1397,34668
LGA21010,3726,1677,136,150,5689
LGA21110,40239,13848,3142,2365,59594
LGA21180,46474,10509,1786,2814,61583
LGA21270,1682,870,62,76,2690
LGA21370,9750,3705,339,539,14333
LGA21450,19784,4624,628,865,25901
LGA21610,66055,12655,1767,2241,82718
LGA21670,3340,1767,142,159,5408
LGA21750,5272,2352,226,324,8174
LGA21830,4326,1744,125,201,6396
LGA21890,33514,14372,3740,2575,54201
LGA22110,11574,4866,422,809,17671
LGA22170,33393,12349,1665,1927,49334
LGA22250,2764,1327,67,196,4354
LGA22310,33327,13866,2705,2000,51898
LGA22410,5243,2298,171,325,8037
LGA22490,5124,1081,98,174,6477
LGA22620,26282,10304,1634,1418,39638
LGA22670,33636,10170,1688,1596,47090
LGA22750,55707,22069,2748,2871,83395
LGA22830,15435,5708,665,991,22799
LGA22910,3810,1794,163,301,6068
LGA22980,1545,741,55,69,2410
LGA23110,22006,7900,1236,1387,32529
LGA23190,5151,2267,213,274,7905
LGA23270,42697,8495,1053,2030,54275
LGA23350,4105,1385,115,230,5835
LGA23430,37881,13914,1645,1881,55321
LGA23670,40746,10023,1287,1058,53114
LGA23810,19067,8103,785,1165,29120
LGA23940,1979,981,77,193,3230
LGA24130,11353,2899,268,544,15064
LGA24210,31076,6775,776,895,39522
LGA24250,2009,897,79,173,3158
LGA24330,17155,7210,2081,2075,28521
LGA24410,27809,9492,1083,852,39236
LGA24600,18135,15187,6653,6785,46760
LGA24650,28519,5692,763,1327,36301
LGA24780,13254,5490,505,1139,20388
LGA24850,9012,2523,281,612,12428
LGA24900,7468,3021,257,571,11317
LGA24970,44283,11797,3295,1920,61295
LGA25060,27979,10614,1965,1870,42428
LGA25150,7647,2214,221,372,10454
LGA25250,36203,15093,4550,2736,58582
LGA25340,38658,14204,1289,2353,56504
LGA25430,4598,2280,219,297,7394
LGA25490,4314,1390,96,250,6050
LGA25620,3510,1401,127,324,5362
LGA25710,16448,2652,262,444,19806
LGA25810,3174,1458,135,222,4989
LGA25900,21072,16597,4401,3940,46010
LGA25990,1770,841,76,97,2784
LGA26080,774,422,20,100,1316
LGA26170,7403,2820,230,432,10885
LGA26260,4330,2034,175,240,6779
LGA26350,22043,13198,3866,3041,42148
LGA26430,2582,1183,87,223,4075
LGA26490,6847,1935,271,576,9629
LGA26610,5201,2081,286,441,8009
LGA26670,1635,656,30,57,2378
LGA26700,7246,3151,239,315,10951
LGA26730,8148,3370,493,572,12583
LGA26810,10885,4422,357,680,16344
LGA26890,1166,569,22,60,1817
LGA26980,39397,13569,2505,1737,57208
LGA27070,41458,7629,1139,1489,51715
LGA27170,9345,3399,478,405,13627
LGA27260,42474,8831,1497,2221,55023
LGA27350,16685,9680,4593,2567,33525
LGA27450,39215,10309,1157,1593,52274
LGA27630,1861,936,55,114,2966
LGA29399,62,53,18,487,620
LGA30250,185,27,9,9,230
LGA30300,1160,410,48,251,1869
LGA30370,3812,1218,132,522,5684
LGA30410,826,342,28,251,1447
LGA30450,87,42,4,62,195
LGA30760,583,270,12,123,988
LGA30900,103,52,9,34,198
LGA31000,261971,91384,27420,17690,398465
LGA31750,85,31,0,82,198
LGA31820,24608,8324,1097,2177,36206
LGA31900,4702,1661,134,513,7010
LGA31950,79,31,3,239,352
LGA32070,39425,14872,2828,6430,63555
LGA32250,428,198,20,610,1256
LGA32260,7311,2656,343,1575,11885
LGA32270,6839,1755,376,2026,10996
LGA32310,3031,1051,122,582,4786
LGA32330,208,33,5,3,249
LGA32450,622,249,38,342,1251
LGA32500,838,453,47,620,1958
LGA32600,72,25,3,58,158
LGA32750,57,39,3,92,191
LGA32770,187,14,9,31,241
LGA33100,217,118,9,314,658
LGA33200,456,187,19,144,806
LGA33220,26384,9200,1162,2619,39365
LGA33360,14874,3839,695,2594,22002
LGA33430,128957,41751,10912,13963,195583
LGA33610,2682,1045,111,370,4208
LGA33620,12525,4436,495,1090,18546
LGA33800,3183,1216,92,403,4894
LGA33830,191,29,4,10,234
LGA33960,42870,11476,1978,2135,58459
LGA33980,5160,1258,236,1262,7916
LGA34420,187,34,8,29,258
LGA34570,90,19,3,20,132
LGA34580,8993,2400,504,664,12561
LGA34590,72120,16050,3127,3569,94866
LGA34710,1043,437,49,499,2028
LGA34770,29431,7757,1379,2465,41032
LGA34800,186,103,9,91,389
LGA34830,53,18,0,19,90
LGA34860,3241,1058,146,653,5098
LGA35010,102227,26514,3863,4822,137426
LGA35250,189,51,7,18,265
LGA35300,4588,1514,300,1711,8113
LGA35600,1146,472,34,269,1921
LGA35670,157,21,0,3,181
LGA35760,2740,1125,123,537,4525
LGA35780,439,109,12,210,770
LGA35790,330,44,9,12,395
LGA35800,444,249,14,191,898
LGA36070,136,22,3,6,167
LGA36150,250,121,9,81,461
LGA36250,38143,9704,1321,1334,50502
LGA36300,215,89,10,89,403
LGA36360,27879,9372,1283,3268,41802
LGA36510,10048,2897,335,515,13795
LGA36580,5891,1709,220,338,8158
LGA36630,8411,3076,375,627,12489
LGA36660,9125,3408,329,479,13341
LGA36710,84729,27375,4611,7081,123796
LGA36810,11435,4343,461,1456,17695
LGA36910,39312,14101,1773,2176,57362
LGA36950,610,174,35,153,972
LGA36960,748,186,11,35,980
LGA37010,44348,13397,3225,4625,65595
LGA37300,783,184,41,236,1244
LGA37310,7887,2697,367,1128,12079
LGA37340,7602,2702,545,2407,13256
LGA37400,350,183,11,194,738
LGA37550,172,45,6,3,226
LGA37570,58,12,0,0,70
LGA37600,378,44,0,0,422
LGA39399,0,0,0,0,0
LGA40070,3402,3443,1330,1264,9439
LGA40120,10870,2507,231,302,13910
LGA40220,6815,2480,212,338,9845
LGA40250,372,144,11,58,585
LGA40310,6303,2037,167,294,8801
LGA40430,677,332,20,66,1095
LGA40520,2880,1209,82,255,4426
LGA40700,11178,4885,532,574,17169
LGA40910,13203,4952,554,446,19155
LGA41010,887,353,36,179,1455
LGA41060,27823,12892,1742,1481,43938
LGA41140,2398,915,84,134,3531
LGA41190,455,214,20,22,711
LGA41330,355,341,17,127,840
LGA41560,3654,1573,127,226,5580
LGA41750,277,136,10,73,496
LGA41830,474,203,8,106,791
LGA41960,338,136,7,68,549
LGA42030,5687,2297,194,291,8469
LGA42110,1133,522,34,85,1774
LGA42250,2162,511,44,102,2819
LGA42600,8773,5398,670,739,15580
LGA42750,1180,558,45,164,1947
LGA43080,287,117,11,16,431
LGA43220,292,113,8,15,428
LGA43360,631,277,21,47,976
LGA43650,3830,876,79,119,4904
LGA43710,1313,385,32,61,1791
LGA43790,3131,1269,72,199,4671
LGA43920,2266,579,77,95,3017
LGA44000,13,9,0,5,27
LGA44060,22256,10119,1465,956,34796
LGA44210,2173,1039,75,273,3560
LGA44340,17068,5885,805,565,24323
LGA44550,8264,2364,270,282,11180
LGA44620,6775,3155,292,294,10516
LGA44830,791,343,19,101,1254
LGA45040,5118,2148,239,327,7832
LGA45090,2242,798,85,111,3236
LGA45120,1251,549,38,66,1904
LGA45290,8570,5441,992,629,15632
LGA45340,44601,14326,1600,1700,62227
LGA45400,246,102,7,33,388
LGA45540,436,315,25,66,842
LGA45680,20831,7268,909,1021,30029
LGA45890,28399,14192,2063,1686,46340
LGA46090,3404,1500,128,621,5653
LGA46300,3706,1625,193,234,5758
LGA46450,4639,2239,135,223,7236
LGA46510,5038,2292,492,246,8068
LGA46670,2449,1052,82,268,3851
LGA46860,373,160,11,76,620
LGA46970,1034,218,66,155,1473
LGA47140,34420,11529,1416,1682,49047
LGA47290,550,266,17,32,865
LGA47490,531,211,15,120,877
LGA47630,1749,653,65,96,2563
LGA47700,27438,7731,796,733,36698
LGA47800,1468,597,52,183,2300
LGA47910,700,334,15,34,1083
LGA47980,9121,4624,892,584,15221
LGA48050,3906,1732,103,399,6140
LGA48130,1723,782,58,91,2654
LGA48260,1778,841,124,175,2918
LGA48340,3178,1336,87,114,4715
LGA48410,13845,7650,1516,817,23828
LGA48540,5774,2928,231,615,9548
LGA48640,324,151,7,24,506
LGA48750,1273,551,39,102,1965
LGA48830,3062,1483,70,367,4982
LGA49399,786,477,47,809,2119
LGA50080,8871,3320,336,550,13077
LGA50210,16672,4643,656,1056,23027
LGA50250,1435,454,50,861,2800
LGA50280,3053,991,163,508,4715
LGA50350,3818,1638,256,226,5938
LGA50420,15911,7041,1395,1156,25503
LGA50490,8646,4092,957,937,14632
LGA50560,446,202,12,28,688
LGA50630,444,123,12,40,619
LGA50770,440,168,7,17,632
LGA50840,1234,459,35,52,1780
LGA50910,234,102,4,23,363
LGA50980,3259,1037,292,2534,7122
LGA51080,302,93,3,15,413
LGA51120,273,117,4,15,409
LGA51190,8150,3678,506,786,13120
LGA51260,8178,2506,314,598,11596
LGA51310,6445,2162,364,341,9312
LGA51330,21736,6567,1776,1194,31273
LGA51400,3912,633,102,218,4865
LGA51470,137,74,7,27,245
LGA51540,1321,574,52,1481,3428
LGA51610,330,80,10,66,486
LGA51680,1237,248,21,69,1575
LGA51750,2281,1150,171,234,3836
LGA51820,24286,6437,1119,1230,33072
LGA51890,2324,882,71,153,3430
LGA51960,883,331,30,201,1445
LGA52030,286,137,4,55,482
LGA52100,289,147,5,17,458
LGA52170,1844,767,167,302,3080
LGA52240,295,112,5,25,437
LGA52310,256,80,4,16,356
LGA52380,58,44,3,77,182
LGA52450,338,127,15,29,509
LGA52520,329,130,10,38,507
LGA52590,815,303,18,249,1385
LGA52660,3404,771,116,173,4464
LGA52730,1423,565,48,146,2182
LGA52800,1220,395,48,1060,2723
LGA52870,1510,432,28,85,2055
LGA52940,198,80,5,8,291
LGA53010,175,79,3,9,266
LGA53080,222,121,9,161,513
LGA53150,1795,697,119,142,2753
LGA53220,1285,343,65,597,2290
LGA53290,3442,1187,98,460,5187
LGA53360,597,227,46,1066,1936
LGA53430,6672,3644,712,860,11888
LGA53520,9406,3255,392,830,13883
LGA53570,1278,389,35,179,1881
LGA53640,325,141,8,40,514
LGA53710,273,109,7,28,417
LGA53780,27623,7216,1263,1712,37814
LGA53920,539,166,24,272,1001
LGA53990,6311,1441,177,499,8428
LGA54060,974,321,29,164,1488
LGA54130,271,110,10,39,430
LGA54170,42717,8849,1435,1530,54531
LGA54200,14805,3579,490,807,19681
LGA54280,7207,2197,469,1493,11366
LGA54340,1052,416,45,67,1580
LGA54410,306,121,9,11,447
LGA54480,155,49,0,10,214
LGA54550,545,188,14,19,766
LGA54620,239,96,3,26,364
LGA54690,116,51,6,11,184
LGA54760,228,86,6,11,331
LGA54830,7433,2213,340,661,10647
LGA54900,365,170,8,32,575
LGA54970,126,73,7,75,281
LGA55040,273,105,8,147,533
LGA55110,19095,6601,762,1357,27815
LGA55180,2481,935,65,227,3708
LGA55250,188,103,13,112,416
LGA55320,25725,8456,1399,1262,36842
LGA55390,49,27,0,34,110
LGA55460,827,361,28,94,1310
LGA55530,126,54,0,19,199
LGA55600,649,219,27,35,930
LGA55670,198,92,6,31,327
LGA55740,2050,1138,172,221,3581
LGA55810,122,66,8,45,241
LGA55880,138,50,4,16,208
LGA55950,154,54,0,14,222
LGA56020,159,62,11,51,283
LGA56090,9873,2297,218,554,12942
LGA56160,27,8,0,14,49
LGA56230,3883,1193,99,311,5486
LGA56300,355,144,16,51,566
LGA56370,237,86,3,11,337
LGA56450,231,45,9,12,297
LGA56520,1037,456,48,64,1605
LGA56580,5306,1426,287,253,7272
LGA56620,247,90,9,61,407
LGA56730,2690,985,102,295,4072
LGA56790,898,354,19,454,1725
LGA56860,56,29,3,8,96
LGA56930,375,99,17,44,535
LGA57000,148,41,8,14,211
LGA57080,3374,3037,748,1983,9142
LGA57140,325,115,10,15,465
LGA57210,1341,431,29,98,1899
LGA57280,2769,739,202,1451,5161
LGA57350,287,121,13,11,432
LGA57420,503,201,10,106,820
LGA57490,27731,7427,1000,1714,37872
LGA57560,4111,922,253,2120,7406
LGA57630,28,14,0,39,81
LGA57700,4816,719,108,200,5843
LGA57770,215,118,14,484,831
LGA57840,9980,5160,1118,1213,17471
LGA57910,49864,23280,4174,4465,81783
LGA57980,4073,2757,628,646,8104
LGA58050,28519,7018,1004,1799,38340
LGA58190,102,44,4,6,156
LGA58260,165,76,4,21,266
LGA58330,1245,369,28,130,1772
LGA58400,97,44,3,9,153
LGA58470,51,24,0,24,99
LGA58510,7510,4425,1148,1016,14099
LGA58540,223,110,13,31,377
LGA58570,7304,4133,1374,1161,13972
LGA58610,495,222,13,21,751
LGA58680,140,24,0,13,177
LGA58760,40448,8230,1198,2104,51980
LGA58820,980,339,20,46,1385
LGA58890,259,92,0,16,367
LGA59030,66,29,3,10,108
LGA59100,207,78,3,11,299
LGA59170,270,89,5,15,379
LGA59250,81,24,6,65,176
LGA59310,375,171,15,34,595
LGA59320,118,36,3,3,160
LGA59330,127,87,5,25,244
LGA59340,1578,555,134,1439,3706
LGA59350,41,15,0,23,79
LGA59360,329,142,7,73,551
LGA59370,953,348,27,68,1396
LGA59399,0,0,0,3,3
LGA60210,1680,848,58,140,2726
LGA60410,4169,1056,118,276,5619
LGA60610,5204,2215,200,245,7864
LGA60810,5913,2220,154,258,8545
LGA61010,621,268,17,67,973
LGA61210,2153,769,47,119,3088
LGA61410,14265,5147,429,597,20438
LGA61510,2684,923,66,98,3771
LGA61610,6664,2828,270,321,10083
LGA61810,1856,794,44,105,2799
LGA62010,217,119,9,33,378
LGA62210,1860,685,59,87,2691
LGA62410,1142,530,46,112,1830
LGA62610,11674,6032,591,538,18835
LGA62810,11658,6356,1599,1010,20623
LGA63010,4236,1429,145,174,5984
LGA63210,1708,486,54,67,2315
LGA63410,418,238,21,34,711
LGA63610,9509,2858,269,364,13000
LGA63810,2764,953,63,114,3894
LGA64010,16363,7855,1216,970,26404
LGA64210,5254,1937,136,178,7505
LGA64610,3450,1211,87,166,4914
LGA64810,3669,1355,110,196,5330
LGA65010,1662,554,36,100,2352
LGA65210,645,289,20,58,1012
LGA65410,3794,1475,105,148,5522
LGA65610,1204,672,52,221,2149
LGA65810,6141,1940,181,262,8524
LGA69399,0,0,0,0,0
LGA70200,5716,2142,544,1347,9749
LGA70420,1115,350,65,463,1993
LGA70540,26,5,0,3,34
LGA70620,554,99,12,120,785
LGA70700,239,143,18,217,617
LGA71000,16697,5632,1917,3563,27809
LGA71300,1045,136,22,60,1263
LGA72200,2035,647,108,740,3530
LGA72300,4346,1045,185,1546,7122
LGA72330,773,211,20,370,1374
LGA72800,6822,1546,448,796,9612
LGA73600,843,197,36,723,1799
LGA74050,470,81,10,14,575
LGA74500,904,232,36,336,1508
LGA74560,105,56,6,11,178
LGA74660,817,193,17,510,1537
LGA79399,1538,602,86,880,3106
LGA89399,91979,30248,7198,5609,135034
LGA99399,536,135,24,120,815
