region_id,C11_Tot_res_Bo_par_bo_os,C11_Tot_res_Fa_onl_bo_os,C11_Tot_res_Mo_onl_bo_os,C11_Tot_res_Bo_pa_bo_Aus,C11_Tot_resp_Bplace_ns,C11_Tot_resp_Tot_resp,C11_T_P_BP_B_OS,C11_T_P_Fa_only_bor_os,C11_T_P_Mo_O_B_OS,C11_T_P_BP_B_Aus,C11_T_P_Bplace_NS,C11_T_P_Tot_resp
LGA10050,7093,4116,2699,46231,3506,63645,6111,2520,1663,34132,3211,47637
LGA10110,3874,2179,1624,23513,2032,33222,3220,1300,957,17135,1876,24488
LGA10150,25166,4248,2729,15463,3476,51082,22924,2578,1648,10631,3315,41096
LGA10200,58538,3318,2300,9695,8006,81857,55157,2367,1603,7158,7825,74110
LGA10250,6213,4162,3076,37465,2463,53379,5108,2537,1852,27721,2238,39456
LGA10300,315,119,87,2271,267,3059,271,89,55,1729,246,2390
LGA10350,114205,16521,8864,58085,15071,212746,105987,11750,6126,43772,14430,182065
LGA10470,4728,3301,2426,37802,3427,51684,3909,1988,1461,28128,3198,38684
LGA10550,5722,3202,2269,29697,2086,42976,4737,1988,1393,21987,1917,32022
LGA10600,2321,1496,990,11708,604,17119,1854,891,579,8563,543,12430
LGA10650,836,564,368,7832,510,10110,717,349,227,6043,468,7804
LGA10750,169401,26682,17996,131898,20243,366220,153742,16691,11191,99509,18765,299898
LGA10800,396,343,225,6504,288,7756,333,214,135,4955,248,5885
LGA10850,607,553,367,7103,463,9093,508,335,211,5376,430,6860
LGA10900,19778,12113,7860,60117,5347,105215,16006,7088,4634,42415,4833,74976
LGA10950,200,141,98,3116,277,3832,162,87,59,2435,256,2999
LGA11000,249,175,129,2383,135,3071,234,104,80,1830,121,2369
LGA11050,210,145,101,2532,100,3088,174,85,64,1905,93,2321
LGA11100,24465,3552,2559,14637,3214,48427,22136,2218,1582,10740,3014,39690
LGA11150,202,124,113,2962,529,3930,179,89,72,2300,505,3145
LGA11200,72,78,33,1832,120,2135,66,49,21,1553,114,1803
LGA11250,1401,1166,610,18825,1762,23764,1222,745,384,14755,1655,18761
LGA11300,23158,2307,1542,8051,2410,37468,21781,1520,997,5786,2332,32416
LGA11350,8220,4432,2986,23331,2619,41588,6462,2665,1776,16757,2340,30000
LGA11400,1168,932,675,13114,659,16548,961,582,410,9991,579,12523
LGA11450,15805,7730,4880,42664,2970,74049,13642,4781,2979,32090,2695,56187
LGA11500,64483,15243,10359,82998,11687,184770,57153,9423,6402,62090,10730,145798
LGA11520,41086,8241,5402,33974,5720,94423,37266,5241,3325,24170,5447,75449
LGA11550,100322,9796,5879,28446,11916,156359,93897,6753,3946,21057,11363,137016
LGA11600,294,171,139,2628,151,3383,249,106,79,1997,142,2573
LGA11700,238,117,69,2248,212,2884,189,72,45,1844,198,2348
LGA11720,5236,4116,2776,49994,4100,66222,4337,2543,1713,38330,3771,50694
LGA11730,5468,4071,2891,50601,3382,66413,4525,2509,1790,38210,3108,50142
LGA11750,502,258,252,4939,519,6470,416,157,143,3778,494,4988
LGA11800,12997,7092,4914,62531,5113,92647,11009,4334,3070,46467,4636,69516
LGA11860,100,71,95,1706,54,2026,88,48,66,1256,55,1513
LGA12000,272,229,188,4225,255,5169,221,136,115,3266,240,3978
LGA12050,2039,945,679,8391,875,12929,1719,588,416,6233,825,9781
LGA12150,200,111,113,4386,337,5147,150,62,58,3422,308,4000
LGA12200,541,431,244,7528,516,9260,445,268,149,5829,481,7172
LGA12300,1240,751,568,11126,596,14281,1051,477,354,8531,556,10969
LGA12350,1123,808,583,12209,997,15720,940,499,358,9360,943,12100
LGA12500,644,462,285,7138,581,9110,563,289,192,5500,539,7083
LGA12600,3221,2505,1642,41369,2824,51561,2759,1513,1007,31490,2606,39375
LGA12700,646,596,397,8748,478,10865,524,364,249,6619,436,8192
LGA12750,6964,3672,2519,31168,2688,47011,5879,2233,1534,23224,2460,35330
LGA12850,152533,9774,5843,29277,13214,210641,141614,6776,4040,22341,12506,187277
LGA12900,559,442,307,9903,600,11811,456,284,208,7601,521,9070
LGA12950,254,204,170,4729,335,5692,212,132,101,3620,290,4355
LGA13010,733,496,384,8948,720,11281,614,312,239,6730,652,8547
LGA13050,507,356,225,4839,235,6162,431,228,136,3756,215,4766
LGA13100,37978,20587,13846,130648,12214,215273,31445,12447,8415,96600,11161,160068
LGA13310,3466,2212,1532,26650,2379,36239,2908,1336,916,20245,2240,27645
LGA13320,5175,3311,2174,31666,2761,45087,4338,2092,1365,24135,2531,34461
LGA13340,851,638,508,10142,629,12768,686,395,301,7720,570,9672
LGA13380,5522,3756,2609,44761,3362,60010,4669,2308,1599,34168,3072,45816
LGA13450,7259,2150,1099,18413,2085,31006,6621,1469,714,13583,1949,24336
LGA13500,222,125,120,3983,246,4696,192,80,80,3117,205,3674
LGA13550,742,641,466,12916,918,15683,627,404,296,9961,886,12174
LGA13650,302,198,157,4549,294,5500,241,122,90,3546,272,4271
LGA13660,272,235,234,5358,231,6330,230,143,156,4143,191,4863
LGA13700,317,166,162,3706,202,4553,250,103,95,2860,176,3484
LGA13800,13554,7771,5534,51397,4247,82503,11381,4779,3351,38614,3895,62020
LGA13850,290,188,119,3123,211,3931,249,115,72,2402,202,3040
LGA13950,64570,8005,4838,30137,7851,115401,59924,5518,3167,22542,7469,98620
LGA14000,77618,17707,12927,85116,6572,199940,69290,10682,7776,60855,5971,154574
LGA14100,5157,1947,1310,8436,657,17507,4492,1198,806,5924,600,13020
LGA14150,48155,6522,4322,30510,4335,93844,44802,4244,2745,22450,4054,78295
LGA14200,1371,1015,630,16445,1017,20478,1179,625,414,12700,908,15826
LGA14250,157,73,63,1428,93,1814,128,51,38,1107,88,1412
LGA14300,361,288,221,5219,1095,7184,292,180,142,4073,1065,5752
LGA14350,2901,2246,1402,27795,2625,36969,2434,1390,861,21350,2441,28476
LGA14400,4271,2430,1713,17256,882,26552,3588,1487,1017,12675,803,19570
LGA14450,34516,4933,3390,20981,3294,67114,32184,3259,2176,15370,3118,56107
LGA14500,54016,14008,10923,58854,5078,142879,46517,8389,6524,41798,4651,107879
LGA14550,1278,859,575,8714,580,12006,1036,530,348,6592,543,9049
LGA14600,352,311,273,6851,478,8265,294,182,161,5410,425,6472
LGA14650,27654,19225,13076,176368,10373,246696,23277,11783,8006,133196,9297,185559
LGA14700,14996,4469,3274,18130,1599,42468,12811,2656,1978,12656,1488,31589
LGA14750,1336,741,486,10896,864,14323,1180,487,301,8106,815,10889
LGA14800,22996,8134,5423,30607,3587,70747,18889,4838,3179,21194,3325,51425
LGA14850,6210,4343,3093,42272,2603,58521,5021,2608,1836,30890,2333,42688
LGA14870,2560,1735,1140,18555,1831,25821,2173,1092,693,14173,1685,19816
LGA14900,114499,15048,9003,58575,14693,211818,105630,10178,5914,44185,13955,179862
LGA14920,561,435,273,7709,440,9418,442,271,176,5967,409,7265
LGA14950,214,132,106,3261,124,3837,181,81,62,2435,115,2874
LGA15050,7981,5559,4109,66845,3997,88491,6604,3415,2495,50847,3652,67013
LGA15150,18595,5459,4265,21989,3035,53343,15216,3281,2520,15612,2869,39498
LGA15200,39120,9995,6905,36891,6795,99706,34154,5915,4044,25128,6375,75616
LGA15270,2779,1667,1321,21684,1809,29260,2328,1016,801,16336,1657,22138
LGA15300,1014,621,515,13683,1427,17260,838,388,322,10717,1350,13615
LGA15350,12211,3749,2757,15770,2168,36655,9948,2256,1643,11073,2059,26979
LGA15500,679,417,334,6975,465,8870,583,262,200,5420,425,6890
LGA15550,187,126,89,2360,176,2938,150,88,60,1738,162,2198
LGA15650,1690,1100,779,15654,1634,20857,1375,679,486,11961,1562,16063
LGA15700,2597,1674,1193,17934,1162,24560,2162,1029,740,13558,1058,18547
LGA15750,793,666,515,13611,1175,16760,672,410,311,10679,1088,13160
LGA15800,423,359,176,6183,551,7692,371,226,108,4652,507,5864
LGA15850,378,349,221,6880,435,8263,314,221,142,5352,399,6428
LGA15900,27280,15388,10442,133757,10961,197828,23551,9390,6340,98765,10113,148159
LGA15950,30939,7561,5723,32341,6135,82699,26237,4484,3349,22331,5890,62291
LGA16100,843,424,309,4798,407,6781,715,257,174,3605,368,5119
LGA16150,5113,3103,2035,37319,3257,50827,4335,1913,1213,28007,3001,38469
LGA16180,3096,1888,1378,12425,1185,19972,2520,1118,811,9049,1089,14587
LGA16200,1082,867,645,15012,1271,18877,929,535,402,11503,1162,14531
LGA16250,106437,13534,8942,55367,14434,198714,98851,8906,5708,40610,13851,167926
LGA16350,60545,22345,14467,120913,12535,230805,52919,13796,8879,90868,11519,177981
LGA16370,19124,8425,6274,38751,3090,75664,15742,5075,3783,28271,2793,55664
LGA16380,11690,6973,5066,67849,4982,96560,9793,4289,3097,51125,4510,72814
LGA16400,10452,6541,4598,58520,4541,84652,8748,4006,2820,44315,4181,64070
LGA16470,11124,4395,3071,29158,2517,50265,9630,2690,1846,21513,2363,38042
LGA16550,70066,13835,10011,56873,12988,163773,61558,8432,6046,40555,12340,128931
LGA16610,1862,1634,1023,22838,1660,29017,1528,1012,651,17536,1518,22245
LGA16650,64495,8174,4986,28348,8089,114092,59653,5532,3269,20979,7669,97102
LGA16700,60640,10039,6922,43050,6431,127082,55807,6183,4242,30748,6104,103084
LGA16900,18810,8201,5806,45921,3367,82105,16433,5112,3579,34533,3041,62698
LGA16950,16691,9918,6834,79412,7503,120358,14131,6071,4181,59546,6922,90851
LGA17000,2882,1775,1546,22667,1433,30303,2342,1071,955,17275,1301,22944
LGA17050,3401,2320,1890,14732,3006,25349,2741,1373,1107,10422,2901,18544
LGA17100,25793,2031,1530,7170,2980,39504,24384,1382,1005,5262,2900,34933
LGA17150,59251,26718,18465,162340,10596,277370,50856,16344,11275,120081,9636,208192
LGA17200,97168,16956,12355,74168,29570,230217,84603,10118,7331,50859,28850,181761
LGA17310,4373,3496,2363,58735,4253,73220,3675,2135,1459,44774,3926,55969
LGA17350,429,311,194,6317,276,7527,355,188,125,4732,254,5654
LGA17400,714,529,376,6777,517,8913,601,330,224,5079,481,6715
LGA17420,83901,18608,12800,91334,6803,213446,75529,11541,7882,66988,6228,168168
LGA17450,409,243,187,3106,327,4272,344,154,99,2398,294,3289
LGA17500,1324,651,551,10911,698,14135,1118,386,333,8387,643,10867
LGA17550,18494,9448,6563,74369,6330,115204,15284,5830,4068,55438,5767,86387
LGA17620,1325,874,676,13895,997,17767,1127,529,416,10736,939,13747
LGA17640,798,486,321,7297,441,9343,642,303,199,5450,387,6981
LGA17650,565,492,320,6091,309,7777,475,297,201,4587,271,5831
LGA17700,72,60,37,1217,85,1471,61,34,25,923,78,1121
LGA17750,6933,4332,3136,61688,3562,79651,5956,2626,1886,46401,3172,60041
LGA17800,381,198,181,4041,325,5126,329,130,116,3096,303,3974
LGA17850,242,170,139,3315,137,4003,193,109,84,2493,120,2999
LGA17900,995,355,254,6130,802,8536,875,237,164,4817,767,6860
LGA17950,169,137,103,3056,165,3630,141,81,69,2351,147,2789
LGA18000,59236,20011,14443,83354,8017,185061,49960,12094,8657,60771,7290,138772
LGA18020,768,566,429,9744,753,12260,679,360,257,7423,702,9421
LGA18050,34931,8100,5685,24965,7791,81472,29357,4969,3456,17467,7481,62730
LGA18100,280,222,192,3808,211,4713,240,135,113,2864,193,3545
LGA18150,609,467,358,8236,1118,10788,496,284,225,6297,1055,8357
LGA18200,715,391,300,7125,569,9100,634,255,186,5487,516,7078
LGA18250,38518,7675,5934,29762,4027,85916,34452,4607,3577,20976,3808,67420
LGA18350,10057,5698,4003,36961,2866,59585,8282,3442,2409,26978,2566,43677
LGA18400,9545,5461,3736,35390,2378,56510,8032,3320,2261,26785,2162,42560
LGA18450,65603,24813,17212,130016,12226,249870,57937,15170,10520,95922,11149,190698
LGA18500,24499,7227,5062,25969,6145,68902,20190,4472,3098,18063,5842,51665
LGA18550,27235,17184,11357,129529,10574,195879,22765,10584,6991,97787,9621,147748
LGA18710,2364,1530,1220,13818,1114,20046,1927,906,736,10186,1043,14798
LGA18750,1045,844,568,12409,941,15807,883,518,362,9379,860,12002
LGA19399,766,326,203,2689,454,4438,666,197,126,1963,440,3392
LGA20110,3006,1419,965,11067,731,17188,2579,864,582,7984,640,12649
LGA20260,1286,701,529,10684,1132,14332,1099,441,326,8038,1067,10971
LGA20570,12079,7783,5633,92100,6209,123804,10295,4725,3358,68360,5665,92403
LGA20660,41651,13975,9042,82862,6610,154140,37266,8604,5525,60114,6064,117573
LGA20740,6780,3475,2336,24624,2339,39554,5703,2128,1419,18158,2145,29553
LGA20830,7101,4653,3229,38679,2368,56030,5950,2838,1958,28902,2141,41789
LGA20910,33598,11746,8596,61121,5315,120376,28404,7147,5167,44275,4882,89875
LGA21010,1655,1221,733,13333,661,17603,1419,744,456,10004,592,13215
LGA21110,65308,18423,13742,101885,7857,207215,58094,11158,8244,71961,7205,156662
LGA21180,129869,12466,8008,43715,15894,209952,120517,8350,5300,32672,15120,181959
LGA21270,548,306,278,6663,348,8143,440,196,171,5130,311,6248
LGA21370,3628,2341,1797,36258,2486,46510,3092,1482,1134,27606,2257,35571
LGA21450,19853,9614,7025,56100,4318,96910,16876,5870,4263,41958,3865,72832
LGA21610,134705,26062,17947,118633,14811,312158,120134,16161,11104,89048,13621,250068
LGA21670,1525,787,623,12247,750,15932,1284,500,391,9375,688,12238
LGA21750,2368,1441,939,20098,1234,26080,2009,879,588,15256,1113,19845
LGA21830,1760,1091,695,16431,899,20876,1435,663,436,12672,799,16005
LGA21890,70336,14828,8758,65365,10722,170009,64550,9221,5386,46339,10064,135560
LGA22110,6829,3958,2586,38738,2814,54925,5779,2434,1566,29307,2516,41602
LGA22170,42549,16868,11902,84378,9197,164894,36187,10315,7303,62917,8398,125120
LGA22250,812,657,402,10514,678,13063,675,411,270,8102,616,10074
LGA22310,68304,15710,10884,63166,7314,165378,60317,9830,6845,45686,6794,129472
LGA22410,2239,1408,1026,18819,1261,24753,1895,862,635,14448,1135,18975
LGA22490,3194,1908,1340,16925,1025,24392,2650,1146,815,12649,915,18175
LGA22620,10488,7695,5059,102584,6444,132270,8885,4700,3093,76597,5872,99147
LGA22670,106312,6354,4678,26180,10527,154051,98277,4178,3062,19805,9994,135316
LGA22750,51136,23319,15206,171225,13386,274272,44689,14305,9294,127145,12179,207612
LGA22830,12298,4550,2779,52437,4752,76816,11153,2910,1752,39207,4417,59439
LGA22910,2802,1545,1042,12989,907,19285,2334,923,604,9373,824,14058
LGA22980,575,296,221,5948,302,7342,486,192,135,4573,276,5662
LGA23110,40860,9223,6114,42784,5864,104845,36494,5840,3754,31360,5457,82905
LGA23190,1558,1083,742,20269,1198,24850,1380,665,443,15401,1097,18986
LGA23270,90696,16166,9597,74268,12228,202955,83424,10756,6255,55257,11491,167183
LGA23350,1905,1169,955,14603,1112,19744,1553,722,564,10892,1014,14745
LGA23430,65019,15150,11303,79748,8280,179500,57592,9397,6871,58823,7576,140259
LGA23670,63372,17220,11857,91022,6516,189987,56360,10539,7233,67478,5842,147452
LGA23810,16044,7735,4921,58953,5243,92896,13985,4794,3036,44304,4810,70929
LGA23940,856,489,336,7328,584,9593,727,293,207,5541,525,7293
LGA24130,8978,5258,3472,36238,2123,56069,7368,3159,2064,26365,1923,40879
LGA24210,61068,10507,7056,51451,4597,134679,56427,6797,4451,37643,4236,109554
LGA24250,1533,989,674,7687,458,11341,1261,595,403,5596,407,8262
LGA24330,41095,6650,4398,28510,7135,87788,37633,4034,2649,20340,6827,71483
LGA24410,33116,13401,9156,75273,5022,135968,28701,8066,5530,55162,4467,101926
LGA24600,60322,8637,6724,44862,16926,137471,53935,5229,3933,30855,16608,110560
LGA24650,52861,11856,7750,54930,8289,135686,47350,7649,4908,40933,7733,108573
LGA24780,8495,3813,2297,47552,3642,65799,7647,2446,1448,36008,3398,50947
LGA24850,6504,3836,2480,30420,2457,45697,5494,2310,1482,22635,2262,34183
LGA24900,3735,2161,1304,26895,2055,36150,3275,1346,813,20331,1912,27677
LGA24970,104137,13740,9480,67402,8959,203718,96452,8581,5800,49090,8440,168363
LGA25060,48093,11204,7004,61665,6876,134842,43823,7063,4314,44553,6423,106176
LGA25150,5828,3080,2168,24516,1665,37257,4889,1870,1314,18173,1510,27756
LGA25250,77895,16023,9787,67739,11000,182444,71138,10224,6101,48143,10382,145988
LGA25340,37926,18300,12642,107606,10056,186530,32034,11184,7747,80011,9135,140111
LGA25430,2698,1758,1167,16229,1633,23485,2166,1057,706,11757,1525,17211
LGA25490,1583,1054,753,16474,858,20722,1287,650,452,12339,777,15505
LGA25620,2252,1398,997,11407,918,16972,1905,859,592,8474,850,12680
LGA25710,15716,7853,5257,49176,2334,80336,13328,4728,3169,35795,2067,59087
LGA25810,1176,755,544,12058,789,15322,988,477,337,9213,719,11734
LGA25900,41068,11573,7746,51222,9192,120801,35072,7049,4688,35953,8762,91524
LGA25990,872,474,372,6226,538,8482,734,288,237,4712,496,6467
LGA26080,391,325,203,2815,196,3930,331,210,118,2027,188,2874
LGA26170,4596,2662,1894,24384,1546,35082,3934,1623,1186,18185,1375,26303
LGA26260,1676,973,927,17150,832,21558,1399,598,557,12876,737,16167
LGA26350,39240,11143,7996,56112,7559,122050,34009,6856,4842,39817,7157,92681
LGA26430,1280,799,503,8916,630,12128,1083,482,317,6697,563,9142
LGA26490,4707,2978,2207,22723,1557,34172,3851,1782,1344,16809,1416,25202
LGA26610,3611,1271,795,18866,1468,26011,3273,809,498,14339,1370,20289
LGA26670,630,501,409,5774,225,7539,523,309,240,4362,196,5630
LGA26700,3494,2284,1453,26636,1586,35453,2993,1398,888,19732,1405,26416
LGA26730,3313,2261,1503,32179,2392,41648,2811,1386,951,24303,2242,31693
LGA26810,6112,3532,2610,36972,3457,52683,5159,2171,1602,28013,3183,40128
LGA26890,364,247,213,4297,194,5315,300,148,129,3325,183,4085
LGA26980,70670,15978,10834,86533,8164,192179,63953,9622,6514,61968,7622,149679
LGA27070,85196,14051,8116,67833,9744,184940,79153,9532,5318,50814,9175,153992
LGA27170,5266,3358,2466,34177,2005,47272,4489,2028,1465,25508,1796,35286
LGA27260,83326,16419,11687,77707,11404,200543,74399,10287,7190,57583,10632,160091
LGA27350,32351,9253,6431,44233,7414,99682,27766,5528,3829,30195,7026,74344
LGA27450,37841,20881,14255,111960,7734,192671,31871,12506,8555,81993,6931,141856
LGA27630,605,343,317,7036,542,8843,510,218,203,5418,495,6844
LGA29399,1871,1290,961,6902,743,11767,1498,764,562,4830,695,8349
LGA30250,36,13,13,1274,0,1336,38,11,11,1242,3,1305
LGA30300,393,221,198,5228,410,6450,318,139,113,4005,369,4944
LGA30370,1794,1105,802,15438,1031,20170,1541,694,479,11700,966,15380
LGA30410,377,188,185,3698,226,4674,293,120,105,2825,216,3559
LGA30450,45,21,49,521,42,678,36,13,20,387,43,499
LGA30760,149,125,121,2504,158,3057,134,77,67,1908,136,2322
LGA30900,41,35,10,550,43,679,35,18,5,465,40,563
LGA31000,412165,123752,89152,708899,72013,1405981,352155,74428,53579,499870,66876,1046908
LGA31750,106,42,43,691,70,952,74,28,26,521,60,709
LGA31820,15331,8228,5610,84189,6406,119764,12960,5108,3468,62623,5907,90066
LGA31900,2872,1505,898,17548,1206,24029,2552,991,565,12440,1113,17661
LGA31950,206,110,87,1132,261,1796,158,65,55,839,261,1378
LGA32070,49800,18296,15650,124397,18587,226730,41156,11218,9437,90288,17370,169469
LGA32250,379,184,147,2768,386,3864,336,123,100,2189,369,3117
LGA32260,6568,2917,2066,26164,2197,39912,5634,1845,1303,18715,1986,29483
LGA32270,5415,2469,1946,30147,3904,43881,4338,1530,1216,22695,3718,33497
LGA32310,1256,842,704,13230,1013,17045,1009,524,429,9935,945,12842
LGA32330,8,0,0,1218,3,1229,9,0,0,1198,3,1210
LGA32450,644,255,247,4090,793,6029,530,159,151,3083,752,4675
LGA32500,986,417,325,4272,981,6981,824,257,199,3180,963,5423
LGA32600,33,18,15,392,57,515,20,10,9,305,62,406
LGA32750,76,46,37,479,41,679,69,26,24,361,42,522
LGA32770,53,31,12,1274,7,1377,37,17,5,1235,7,1301
LGA33100,255,107,111,1462,98,2033,217,60,68,1101,95,1541
LGA33200,167,150,85,2073,223,2698,130,89,49,1565,199,2032
LGA33220,19131,9144,6575,87161,7116,129127,15895,5624,4086,64570,6509,96684
LGA33360,11004,5189,3978,52825,5804,78800,8966,3182,2442,39701,5448,59739
LGA33430,199720,56687,44470,324265,44301,669443,163610,35054,27453,240418,41649,508184
LGA33610,895,537,441,11094,998,13965,753,334,261,8404,938,10690
LGA33620,7276,4258,3112,43096,3335,61077,6000,2632,1941,32053,3102,45728
LGA33800,2488,1315,773,11145,745,16466,2225,897,511,7848,665,12146
LGA33830,29,0,3,958,54,1044,20,0,4,947,51,1022
LGA33960,47221,18270,13386,130457,12529,221863,38863,11127,8179,95686,11420,165275
LGA33980,4788,2217,1828,26566,7848,43247,3841,1376,1122,19799,7710,33848
LGA34420,33,14,12,1049,3,1111,30,11,8,1006,4,1059
LGA34570,20,16,10,514,20,580,14,11,9,459,18,511
LGA34580,5933,2996,2289,31929,3084,46231,4981,1850,1387,23534,2854,34606
LGA34590,108738,32117,24437,178010,20892,364194,89738,19617,14980,131882,19021,275238
LGA34710,590,364,330,5268,395,6947,474,240,194,3984,364,5256
LGA34770,19741,9736,7325,104440,7946,149188,16290,6028,4531,76645,7188,110682
LGA34800,242,92,89,1462,331,2216,173,52,44,1091,317,1677
LGA34830,20,6,12,385,0,423,10,6,9,285,0,310
LGA34860,1315,690,558,14143,1485,18191,1118,458,351,10604,1428,13959
LGA35010,103164,44654,32561,300283,23838,504500,83777,27295,19852,220593,21649,373166
LGA35250,52,30,9,1202,29,1322,45,22,3,1113,18,1201
LGA35300,4693,1888,1515,17928,3842,29866,3891,1146,908,13435,3732,23112
LGA35600,501,265,200,4830,467,6263,425,169,129,3734,448,4905
LGA35670,17,0,0,1070,0,1087,15,0,0,805,0,820
LGA35760,1262,682,519,10390,889,13742,1083,444,310,7677,817,10331
LGA35780,181,78,68,3065,125,3517,143,52,44,2235,119,2593
LGA35790,48,32,13,2654,8,2755,53,22,14,2260,14,2363
LGA35800,184,122,67,2172,175,2720,149,62,49,1691,164,2115
LGA36070,35,24,9,713,0,781,23,12,6,648,0,689
LGA36150,132,85,67,1200,54,1538,102,45,41,912,54,1154
LGA36250,45099,16985,12247,103039,7298,184668,36743,10326,7468,75438,6466,136441
LGA36300,89,56,48,944,89,1226,76,32,31,733,74,946
LGA36360,14403,8468,6445,106257,10142,145715,11996,5134,3975,79395,9508,110008
LGA36510,8034,3872,2934,32236,2307,49383,6435,2350,1795,23726,2090,36396
LGA36580,3719,2005,1511,19908,1345,28488,3061,1247,910,14750,1184,21152
LGA36630,4299,2588,1859,30609,1985,41340,3523,1611,1162,22761,1807,30864
LGA36660,4930,2778,2037,33370,2083,45198,4126,1728,1224,24478,1865,33421
LGA36710,86915,37055,27062,251860,19954,422846,70633,22673,16711,184623,18153,312793
LGA36810,10027,4479,3206,37496,4129,59337,8377,2779,1972,27271,3806,44205
LGA36910,21745,12238,8961,148981,9799,201724,18148,7475,5426,109204,8954,149207
LGA36950,389,295,149,3112,556,4501,308,189,89,2383,529,3498
LGA36960,318,157,110,3957,110,4652,298,133,106,3382,104,4023
LGA37010,34868,18186,13669,156985,15206,238914,28785,11098,8313,114378,14182,176756
LGA37300,633,336,245,3173,555,4942,522,206,146,2400,533,3807
LGA37310,3304,1905,1627,33428,3232,43496,2695,1217,989,25057,3069,33027
LGA37340,7883,3161,2521,29599,4544,47708,6534,1949,1569,21879,4342,36273
LGA37400,192,110,81,1929,109,2421,167,72,52,1467,100,1858
LGA37550,10,9,0,947,16,982,10,4,3,908,10,935
LGA37570,0,10,0,285,0,295,3,6,0,273,0,282
LGA37600,12,17,0,2458,10,2497,14,8,5,2352,13,2392
LGA39399,983,304,228,2247,1218,4980,825,188,144,1613,1194,3964
LGA40070,11498,2139,1544,12122,4004,31307,10236,1305,937,8448,3920,24846
LGA40120,10375,5352,3705,30209,1744,51385,8587,3119,2215,22130,1554,37605
LGA40220,5529,2418,1833,19759,1150,30689,4734,1458,1111,14775,1028,23106
LGA40250,134,64,48,2280,47,2573,114,38,26,2194,53,2425
LGA40310,4211,2248,1738,19995,887,29079,3526,1347,1026,15119,805,21823
LGA40430,283,155,128,2402,122,3090,230,91,74,1897,114,2406
LGA40520,2080,850,608,9317,797,13652,1853,534,375,7049,725,10536
LGA40700,16406,4913,3580,27526,2189,54614,14453,3016,2141,19941,2017,41568
LGA40910,24693,5043,2884,24250,2132,59002,22619,3262,1822,17926,1976,47605
LGA41010,415,271,177,3732,253,4848,339,173,112,2928,241,3793
LGA41060,45057,11170,6858,61779,6339,131203,40842,7177,4256,45816,5823,103914
LGA41140,1318,646,598,8681,425,11668,1072,379,353,6526,378,8708
LGA41190,125,78,90,1865,40,2198,100,55,48,1464,42,1709
LGA41330,671,162,122,1419,220,2594,608,102,74,1023,212,2019
LGA41560,1835,951,732,12134,665,16317,1559,613,461,9493,600,12726
LGA41750,106,55,51,1227,49,1488,91,34,32,906,38,1101
LGA41830,199,105,86,1886,125,2401,167,68,58,1401,121,1815
LGA41960,118,101,74,1279,139,1711,101,58,39,947,127,1272
LGA42030,5816,2428,1988,15126,1319,26677,4988,1450,1194,11395,1184,20211
LGA42110,592,277,270,4059,255,5453,503,175,155,3073,225,4131
LGA42250,856,547,342,7562,525,9832,718,340,217,5845,480,7600
LGA42600,11335,3847,2538,25325,2465,45510,9694,2346,1563,18582,2324,34509
LGA42750,866,402,319,3864,260,5711,715,244,188,2933,251,4331
LGA43080,116,56,48,1049,85,1354,88,35,37,805,69,1034
LGA43220,60,54,64,1168,77,1423,44,31,36,898,73,1082
LGA43360,193,104,150,2172,128,2747,165,69,96,1710,109,2149
LGA43650,3011,1532,1267,11918,679,18407,2523,910,748,8908,600,13689
LGA43710,494,385,271,4804,291,6245,412,232,171,3660,275,4750
LGA43790,1452,757,553,11433,520,14715,1271,469,336,8725,478,11279
LGA43920,2038,904,708,6401,489,10540,1755,562,448,4944,437,8146
LGA44000,4,3,6,54,12,79,3,3,3,52,12,73
LGA44060,29472,9113,6536,56735,4356,106212,25976,5541,3978,42026,3955,81476
LGA44210,1333,626,472,7280,778,10489,1144,384,303,5492,749,8072
LGA44340,20486,8136,5684,46527,2565,83398,17702,4886,3440,33883,2300,62211
LGA44550,6813,3732,2677,25437,1186,39845,5599,2217,1602,18635,1042,29095
LGA44620,4103,2152,1443,23678,1317,32693,3526,1333,880,17963,1172,24874
LGA44830,409,191,133,2946,191,3870,349,115,91,2250,172,2977
LGA45040,3321,1508,1133,17737,1789,25488,2916,918,692,13289,1692,19507
LGA45090,1267,503,434,7672,520,10396,1072,311,254,5877,465,7979
LGA45120,462,238,293,4605,203,5801,388,147,176,3509,186,4406
LGA45290,14897,4040,2722,20920,2048,44627,13354,2499,1642,15023,1870,34388
LGA45340,51540,20229,14980,112246,8730,207725,43782,12175,9004,83751,7794,156506
LGA45400,105,34,42,965,26,1172,85,27,29,713,32,886
LGA45540,293,149,125,1593,176,2336,240,92,70,1209,163,1774
LGA45680,27236,10003,7826,51670,6004,102739,23492,6115,4780,38714,5493,78594
LGA45890,49792,11470,7604,63539,8592,140997,44993,7099,4616,47141,8043,111892
LGA46090,1568,1016,617,12837,2000,18038,1363,616,381,9942,1909,14211
LGA46300,1914,1360,862,13470,893,18499,1615,846,536,10120,798,13915
LGA46450,2086,1320,818,16663,1013,21900,1856,836,500,12984,912,17088
LGA46510,8254,2364,1502,12348,1071,25539,7409,1460,906,8957,972,19704
LGA46670,2049,669,423,7920,802,11863,1829,440,280,5999,761,9309
LGA46860,164,112,114,1393,104,1887,141,70,66,1047,96,1420
LGA46970,1197,576,395,4274,1055,7497,995,331,236,3201,1028,5791
LGA47140,54697,14014,10341,74338,9138,162528,48853,8685,6332,55643,8385,127898
LGA47290,261,122,90,2134,94,2701,214,66,53,1639,85,2057
LGA47490,223,134,134,2121,144,2756,183,88,86,1624,142,2123
LGA47630,919,365,308,6508,235,8335,821,231,184,5030,208,6474
LGA47700,35390,12392,8829,62567,4244,123422,30743,7543,5342,46386,3761,93775
LGA47800,589,342,332,5276,463,7002,489,217,213,4042,427,5388
LGA47910,229,174,143,2576,88,3210,196,109,94,1988,78,2465
LGA47980,12559,4753,3038,25914,2317,48581,11025,2844,1814,18493,2180,36356
LGA48050,3429,1285,847,10612,1077,17250,2957,784,522,8024,997,13284
LGA48130,954,535,428,6238,395,8550,821,326,250,4741,351,6489
LGA48260,2628,780,639,4707,416,9170,2337,483,392,3430,401,7043
LGA48340,1633,891,694,10814,551,14583,1406,549,429,8350,502,11236
LGA48410,23406,5775,3760,32655,3457,69053,21349,3656,2318,23960,3214,54497
LGA48540,6807,2546,1866,15686,1858,28763,5783,1547,1132,11985,1713,22160
LGA48640,91,65,71,1392,43,1662,88,34,48,1062,34,1266
LGA48750,1211,434,357,3523,236,5761,1014,272,212,2641,212,4351
LGA48830,1468,674,603,10690,518,13953,1251,425,374,8361,464,10875
LGA49399,1346,608,421,6210,960,9545,1120,375,257,4659,927,7338
LGA50080,9483,4606,3656,24190,2041,43976,7937,2851,2214,17857,1878,32737
LGA50210,28040,9164,7249,31224,4911,80588,23563,5513,4325,23126,4538,61065
LGA50250,4554,1459,1209,9377,2673,19272,3624,910,738,6999,2606,14877
LGA50280,3669,1719,1436,7904,1052,15780,2941,1039,853,5762,987,11582
LGA50350,6210,2166,1616,7907,1012,18911,5241,1318,959,5693,922,14133
LGA50420,34541,7696,5112,25402,4292,77043,30024,4742,3089,18453,3986,60294
LGA50490,18335,4165,2952,15938,3461,44851,15989,2534,1782,11721,3283,35309
LGA50560,361,155,118,1228,107,1969,297,99,66,939,99,1500
LGA50630,676,278,231,1601,697,3483,546,167,145,1222,674,2754
LGA50770,389,194,144,1222,79,2028,310,125,93,926,65,1519
LGA50840,1422,616,484,3052,208,5782,1203,391,293,2203,177,4267
LGA50910,118,90,70,758,77,1113,120,55,40,606,70,891
LGA50980,4559,2433,1585,16807,2613,27997,3813,1501,955,12905,2487,21661
LGA51080,186,102,94,1054,59,1495,150,59,52,795,58,1114
LGA51120,193,81,66,831,72,1243,150,50,42,641,67,950
LGA51190,9454,3916,2808,21728,3053,40959,7890,2444,1699,16253,2823,31109
LGA51260,7991,4365,3042,22477,1995,39870,6613,2693,1840,16596,1823,29565
LGA51310,10704,3954,2785,14958,1264,33665,8893,2391,1647,10745,1169,24845
LGA51330,52462,8888,6708,31659,5053,104770,46579,5327,4033,23340,4776,84055
LGA51400,4271,1878,1495,10147,995,18786,3558,1165,886,7572,903,14084
LGA51470,146,53,20,477,50,746,101,28,16,360,47,552
LGA51540,2253,775,623,5997,1095,10743,1943,499,384,4753,1054,8633
LGA51610,221,144,77,1061,91,1594,202,85,53,793,73,1206
LGA51680,1455,584,499,2852,267,5657,1228,353,293,2168,243,4285
LGA51750,3768,1319,979,5468,770,12304,3100,796,601,3925,724,9146
LGA51820,43481,12327,8813,44833,5296,114750,37375,7639,5345,32880,4821,88060
LGA51890,2575,1165,828,7430,935,12933,2111,715,515,5622,891,9854
LGA51960,1414,398,320,2724,680,5536,1095,254,200,2135,655,4339
LGA52030,215,118,115,913,61,1422,179,72,69,691,54,1065
LGA52100,158,78,72,919,36,1263,144,50,50,723,31,998
LGA52170,2533,1057,818,4966,801,10175,2013,642,503,3583,776,7517
LGA52240,278,106,113,809,77,1383,231,66,66,602,74,1039
LGA52310,176,102,60,739,40,1117,144,65,36,557,36,838
LGA52380,100,51,24,297,77,549,80,31,25,225,68,429
LGA52450,266,139,136,1113,91,1745,233,76,85,826,85,1305
LGA52520,244,153,100,1108,53,1658,207,90,75,839,46,1257
LGA52590,746,406,276,2513,366,4307,632,253,172,1935,351,3343
LGA52660,2954,1471,1222,9657,802,16106,2425,910,737,7129,732,11933
LGA52730,1895,827,654,3293,286,6955,1498,500,382,2372,261,5013
LGA52800,1407,602,407,7879,2607,12902,1172,385,255,6592,2586,10990
LGA52870,1485,720,486,3832,285,6808,1248,429,310,2834,266,5087
LGA52940,96,72,74,625,31,898,83,39,43,482,31,678
LGA53010,97,68,62,546,19,792,82,39,34,393,18,566
LGA53080,505,158,116,1177,284,2240,393,97,74,863,265,1692
LGA53150,2695,1082,822,4338,515,9452,2199,647,476,3068,469,6859
LGA53220,5060,1421,1109,9827,4015,21432,4088,871,672,7437,3946,17014
LGA53290,2686,1597,1153,10828,1172,17436,2213,977,711,8305,1074,13280
LGA53360,1244,568,433,3399,336,5980,1049,366,279,2599,311,4604
LGA53430,12446,4111,2825,14379,2439,36200,10334,2475,1650,10207,2295,26961
LGA53520,7853,4028,3062,29948,3126,48017,6493,2471,1846,22589,2881,36280
LGA53570,1464,533,461,2873,420,5751,1244,337,292,2206,387,4466
LGA53640,191,121,121,1169,110,1712,153,73,73,877,89,1265
LGA53710,153,67,90,884,65,1259,125,44,58,692,61,980
LGA53780,57033,12827,9682,44603,8978,133123,49689,7757,5838,33261,8420,104965
LGA53920,521,203,107,4147,235,5213,433,134,61,3691,222,4541
LGA53990,6650,2950,2153,16613,1595,29961,5486,1826,1318,12349,1467,22446
LGA54060,807,479,349,2940,203,4778,667,294,206,2207,190,3564
LGA54130,165,110,61,918,47,1301,133,65,42,697,42,979
LGA54170,82668,20163,15609,70660,7114,196214,68974,12082,9303,52469,6436,149264
LGA54200,22806,7924,5701,30233,3387,70051,18894,4770,3416,22301,3086,52467
LGA54280,10116,3097,2424,21121,4493,41251,8140,1881,1449,15911,4326,31707
LGA54340,1259,415,312,2916,324,5226,1121,272,197,2250,279,4119
LGA54410,206,118,101,966,78,1469,171,82,51,768,71,1143
LGA54480,66,17,60,480,15,638,50,14,34,385,12,495
LGA54550,394,222,166,1611,113,2506,326,133,105,1215,86,1865
LGA54620,270,114,121,897,153,1555,207,80,73,679,153,1192
LGA54690,73,40,51,397,14,575,63,26,35,284,12,420
LGA54760,145,78,96,711,19,1049,117,44,53,556,13,783
LGA54830,12310,4080,3065,15010,3373,37838,10113,2421,1852,11099,3181,28666
LGA54900,277,127,138,1116,58,1716,231,75,85,836,55,1282
LGA54970,710,174,152,1299,302,2637,576,103,88,1012,293,2072
LGA55040,1304,370,280,2227,1284,5465,1029,224,165,1640,1263,4321
LGA55110,24392,8676,6516,42660,5534,87778,20337,5351,4015,32106,5076,66885
LGA55180,2516,1316,901,7042,571,12346,2072,800,543,5131,502,9048
LGA55250,501,150,139,1244,452,2486,407,90,85,1007,439,2028
LGA55320,46943,12985,9490,48535,5033,122986,40313,7857,5678,35446,4614,93908
LGA55390,74,28,25,412,42,581,66,15,13,357,44,495
LGA55460,734,379,296,2567,241,4217,629,242,190,1965,220,3246
LGA55530,71,60,46,451,28,656,56,31,26,353,22,488
LGA55600,455,220,198,2126,153,3152,384,141,119,1619,145,2408
LGA55670,144,117,95,804,113,1273,137,65,59,600,97,958
LGA55740,3738,1215,900,4828,613,11294,3075,748,547,3477,576,8423
LGA55810,192,80,66,633,150,1121,151,48,36,521,158,914
LGA55880,92,65,36,457,21,671,61,35,24,340,15,475
LGA55950,87,38,61,467,6,659,64,30,33,352,12,491
LGA56020,174,56,55,741,90,1116,134,25,34,576,85,854
LGA56090,13615,5548,4027,20991,3629,47810,11065,3333,2394,15433,3422,35647
LGA56160,25,16,12,94,12,159,20,9,3,85,12,129
LGA56230,3860,1814,1423,9630,1033,17760,3185,1125,882,7378,966,13536
LGA56300,405,164,150,947,97,1763,320,105,87,670,79,1261
LGA56370,162,65,49,685,56,1017,140,59,30,522,54,805
LGA56450,178,112,117,721,32,1160,154,65,61,533,30,843
LGA56520,924,500,381,3431,292,5528,737,296,239,2616,270,4158
LGA56580,9643,3104,2481,11871,1459,28558,8003,1865,1456,8510,1379,21213
LGA56620,130,49,29,1419,52,1679,109,28,14,1351,55,1557
LGA56730,2567,1237,936,7561,1026,13327,2148,749,563,5766,963,10189
LGA56790,967,443,326,3194,336,5266,825,287,206,2479,312,4109
LGA56860,31,30,7,200,31,299,31,25,9,150,25,240
LGA56930,484,203,238,1029,132,2086,386,117,135,744,133,1515
LGA57000,417,134,101,887,133,1672,339,82,59,655,136,1271
LGA57080,12287,1589,1220,7190,4450,26736,10699,967,727,5033,4410,21836
LGA57140,235,129,72,903,78,1417,191,76,45,703,73,1088
LGA57210,1337,579,514,3341,393,6164,1128,364,314,2499,364,4669
LGA57280,5129,1679,1328,10617,4347,23100,4198,1005,803,8085,4247,18338
LGA57350,144,113,74,886,49,1266,133,74,42,701,39,989
LGA57420,600,296,183,1642,206,2927,491,177,116,1256,189,2229
LGA57490,47387,14359,11468,53445,7275,133934,39567,8657,6855,39625,6663,101367
LGA57560,8761,2564,2035,16229,7447,37036,7194,1560,1242,12275,7337,29608
LGA57630,35,13,25,117,17,207,32,12,12,88,17,161
LGA57700,6347,2662,2177,10558,1207,22951,5276,1602,1336,7909,1104,17227
LGA57770,515,288,154,1451,145,2553,448,177,99,1117,137,1978
LGA57840,20176,4934,3907,20542,3156,52715,17306,2969,2347,14745,3011,40378
LGA57910,102575,24633,17242,87911,14865,247226,89216,15245,10475,63881,14030,192847
LGA57980,9104,2553,1783,8636,1626,23702,7639,1513,1042,6067,1528,17789
LGA58050,49931,14700,11146,55546,8261,139584,42456,8931,6770,41185,7616,106958
LGA58190,65,30,30,349,33,507,60,18,19,270,23,390
LGA58260,141,52,64,500,57,814,125,32,43,403,56,659
LGA58330,1303,621,411,2859,392,5586,1082,400,250,2132,371,4235
LGA58400,74,40,28,270,20,432,70,28,14,207,17,336
LGA58470,19,15,17,238,33,322,23,7,8,216,31,285
LGA58510,17587,3797,2935,13584,3465,41368,15333,2284,1713,9813,3353,32496
LGA58540,201,100,84,760,67,1212,155,50,53,574,60,892
LGA58570,16557,4462,2970,14059,2867,40915,14102,2677,1750,9799,2722,31050
LGA58610,434,207,210,1393,101,2345,358,125,125,1086,80,1774
LGA58680,111,48,50,350,19,578,92,31,32,264,23,442
LGA58760,87621,18414,14153,60013,10478,190679,74857,11220,8576,44683,9664,149000
LGA58820,988,437,388,2634,198,4645,851,280,241,1950,176,3498
LGA58890,135,88,71,763,48,1105,106,54,42,600,43,845
LGA59030,78,21,18,234,14,365,67,11,21,172,18,289
LGA59100,82,70,69,640,60,921,84,48,40,469,47,688
LGA59170,107,91,106,799,43,1146,94,51,61,631,42,879
LGA59250,756,154,134,1226,284,2554,593,93,82,942,280,1990
LGA59310,206,147,89,1260,88,1790,174,87,60,976,87,1384
LGA59320,66,40,38,326,24,494,55,26,25,257,18,381
LGA59330,106,48,27,406,64,651,78,35,25,317,58,513
LGA59340,2199,879,716,9308,1436,14538,1825,542,454,7318,1380,11519
LGA59350,202,56,31,458,143,890,155,33,30,334,136,688
LGA59360,669,271,202,1470,351,2963,532,162,128,1048,340,2210
LGA59370,891,437,337,2516,229,4410,724,257,189,1884,213,3267
LGA59399,1015,296,253,1632,573,3769,828,177,147,1179,559,2890
LGA60210,1064,461,347,5449,418,7739,860,277,205,4244,385,5971
LGA60410,1181,895,474,15230,1338,19118,966,559,296,12198,1269,15288
LGA60610,2274,1436,865,18687,1256,24518,1921,866,521,14563,1169,19040
LGA60810,2513,1443,1060,19924,1215,26155,2143,890,645,15654,1122,20454
LGA61010,269,113,68,2106,178,2734,217,82,42,1712,167,2220
LGA61210,910,483,330,7815,489,10027,741,286,201,6133,448,7809
LGA61410,7468,4863,3153,46916,3317,65717,6249,2976,1891,36311,3060,50487
LGA61510,1059,610,367,9391,627,12054,876,362,222,7539,567,9566
LGA61610,2819,1655,1142,23273,1661,30550,2400,1012,713,18297,1499,23921
LGA61810,673,353,326,6642,388,8382,554,228,197,5256,364,6599
LGA62010,110,42,39,731,49,971,94,26,24,557,47,748
LGA62210,1000,608,338,5966,433,8345,846,374,216,4696,376,6508
LGA62410,602,278,245,3923,244,5292,498,167,135,3029,241,4070
LGA62610,6822,3791,2174,40515,2904,56206,6050,2296,1346,31562,2661,43915
LGA62810,14506,6648,4488,37971,3553,67166,12261,3942,2647,27388,3320,49558
LGA63010,3034,1436,1064,13324,760,19618,2476,852,645,10126,660,14759
LGA63210,1042,500,318,5705,285,7850,861,298,192,4441,259,6051
LGA63410,292,159,74,1409,89,2023,260,97,52,1062,78,1549
LGA63610,8478,4083,2980,27268,1589,44398,7050,2393,1740,20310,1403,32896
LGA63810,1202,601,450,9406,500,12159,1009,363,269,7401,460,9502
LGA64010,10156,5842,4002,59062,4267,83329,8725,3545,2416,45553,3901,64140
LGA64210,2795,1330,1140,17660,979,23904,2323,800,684,13821,896,18524
LGA64610,1448,841,579,11798,572,15238,1219,523,367,9396,519,12024
LGA64810,1585,1163,715,12376,803,16642,1314,695,456,9635,727,12827
LGA65010,541,350,215,5899,429,7434,437,222,133,4689,398,5879
LGA65210,417,208,120,1992,173,2910,330,123,68,1527,154,2202
LGA65410,1759,881,704,12965,762,17071,1483,535,455,10248,687,13408
LGA65610,604,387,247,4865,415,6518,490,241,143,3795,380,5049
LGA65810,4251,2129,1491,18985,1116,27972,3611,1289,894,14501,1022,21317
LGA69399,162,56,32,428,77,755,126,35,24,312,74,571
LGA70200,7465,2459,1937,20150,3193,35204,6215,1468,1174,15243,3048,27148
LGA70420,775,301,203,6374,902,8555,634,186,128,5727,896,7571
LGA70540,0,7,0,173,0,180,0,3,0,164,0,167
LGA70620,339,136,74,3638,338,4525,283,86,50,3371,337,4127
LGA70700,264,100,78,1215,263,1920,231,65,51,922,246,1515
LGA71000,27657,8063,6661,48152,10991,101524,23888,4920,4039,34928,10530,78305
LGA71300,299,122,90,9024,213,9748,267,81,60,8491,214,9113
LGA72200,1675,788,743,9073,1260,13539,1400,480,451,7003,1203,10537
LGA72300,4001,2128,1838,15750,2907,26624,3322,1289,1089,11869,2786,20355
LGA72330,418,154,72,5347,894,6885,342,102,48,4964,882,6338
LGA72800,6459,3046,2701,21577,3005,36788,5326,1858,1602,15808,2835,27429
LGA73600,605,282,183,6943,567,8580,511,181,115,6300,548,7655
LGA74050,109,45,15,2473,46,2688,98,37,19,2376,45,2575
LGA74500,385,178,114,6241,258,7176,327,126,74,5792,255,6574
LGA74560,98,44,30,313,31,516,75,25,20,215,31,366
LGA74660,782,274,247,6685,458,8446,682,161,145,6102,443,7533
LGA79399,2494,1020,893,7288,2323,14018,2109,612,528,5406,2285,10940
LGA89399,125946,45863,35808,253828,21487,482932,108855,27203,20988,179944,19909,356899
LGA99399,1109,248,211,1461,948,3977,1004,169,156,1168,941,3438
