region_id,C11_OTT_DS_FUA,C11_OTT_DS_OD,C11_OTT_DS_NS_,C11_OTT_Tot,C11_TT_NS_DS_Sep_house,C11_TT_NS_DS_SemiDRTHT,C11_TT_NS_DS_FUA,C11_TT_NS_DS_OD,C11_TT_NS_DS_NS_,C11_TT_NS_T,C11_Tot_DS_Sep_house,C11_Tot_DS_SemiDRTHT,C11_Tot_DS_FUA,C11_Tot_DS_OD,C11_Tot_DS_NS_,C11_T_T
LGA10050,9,3,0,164,707,78,322,17,3,1127,14855,1106,3288,135,16,19400
LGA10110,6,3,0,75,395,41,155,31,0,622,7384,531,1096,111,11,9133
LGA10150,81,0,0,123,352,144,642,18,3,1159,6088,1953,8004,109,32,16186
LGA10200,39,0,0,136,752,209,931,20,0,1912,11411,2832,9110,74,26,23453
LGA10250,109,11,0,205,432,109,176,113,0,830,11383,2091,2123,766,7,16370
LGA10300,0,0,3,13,69,3,9,31,0,112,823,25,30,49,3,930
LGA10350,93,6,3,411,2321,630,1010,45,10,4016,40916,9769,8614,284,101,59684
LGA10470,5,0,3,78,609,112,136,25,4,886,12097,1083,1023,84,34,14321
LGA10550,11,9,0,123,521,61,92,53,0,727,10926,916,1143,437,14,13436
LGA10600,8,9,0,56,176,9,16,19,0,220,4626,107,226,276,4,5239
LGA10650,0,6,0,43,142,14,27,9,0,192,2935,151,174,121,0,3381
LGA10750,31,5,0,504,3565,607,517,59,3,4751,79683,11102,5119,426,73,96403
LGA10800,3,0,0,27,95,0,8,36,0,139,2182,15,101,67,0,2365
LGA10850,0,0,0,18,134,3,4,0,0,141,2514,63,56,26,3,2662
LGA10900,24,0,0,290,1365,114,57,69,3,1608,27116,1506,624,109,22,29377
LGA10950,0,0,0,10,91,3,6,7,5,112,1038,25,33,61,10,1167
LGA11000,0,0,0,11,43,0,0,3,0,46,999,12,15,12,0,1038
LGA11050,0,0,0,18,31,0,0,5,0,36,949,32,0,18,0,999
LGA11100,39,0,0,84,320,128,598,8,0,1054,5785,2154,6832,79,35,14885
LGA11150,0,6,0,20,148,0,8,106,0,262,1011,3,41,149,4,1208
LGA11200,0,0,0,15,40,0,4,0,3,47,570,0,46,10,3,629
LGA11250,5,6,3,63,562,37,55,24,0,678,7410,114,353,166,13,8056
LGA11300,28,0,0,72,286,75,363,23,0,747,5794,1239,4110,83,12,11238
LGA11350,12,3,0,118,596,105,89,433,0,1223,9768,1138,710,756,30,12402
LGA11400,3,3,0,58,162,3,7,3,0,175,4608,65,72,81,0,4826
LGA11450,13,4,0,159,628,70,35,19,0,752,16839,1056,306,179,28,18408
LGA11500,115,3,0,351,1956,590,201,13,5,2765,39275,7694,1933,159,18,49079
LGA11520,60,0,0,150,624,207,1268,36,5,2140,13126,3526,12855,167,63,29737
LGA11550,117,0,0,304,1463,428,1957,63,5,3916,24899,4981,18127,301,154,48462
LGA11600,0,3,0,17,54,0,3,6,0,63,953,6,33,64,0,1056
LGA11700,0,5,3,31,70,0,3,15,3,91,681,0,44,109,58,892
LGA11720,3,6,0,131,990,81,55,26,6,1158,17342,923,589,122,22,18998
LGA11730,14,11,3,143,739,52,88,292,4,1175,17340,839,1257,1031,31,20498
LGA11750,0,3,0,15,127,3,4,25,3,162,1657,22,144,118,22,1963
LGA11800,50,27,3,350,899,179,255,103,0,1436,20471,3001,2780,1346,16,27614
LGA11860,0,0,0,14,28,0,0,0,0,28,569,0,0,10,0,579
LGA12000,6,0,0,20,88,0,11,4,0,103,1468,3,61,22,0,1554
LGA12050,3,0,0,30,165,18,12,14,0,209,3624,199,129,58,7,4017
LGA12150,0,3,0,25,109,3,3,6,0,121,1527,35,39,40,3,1644
LGA12200,4,0,0,21,149,3,13,4,0,169,2848,40,150,21,0,3059
LGA12300,9,3,0,38,195,14,30,30,0,269,3916,146,419,124,6,4611
LGA12350,0,0,0,43,343,13,35,12,50,453,4552,148,235,74,53,5062
LGA12500,3,0,0,14,191,22,15,11,0,239,2683,176,139,84,9,3091
LGA12600,82,3,0,153,515,62,114,140,0,831,12284,835,1289,252,4,14664
LGA12700,3,0,0,39,155,8,0,6,0,169,3134,55,31,23,0,3243
LGA12750,26,11,0,171,707,109,110,108,3,1037,12723,1105,987,503,19,15337
LGA12850,46,0,3,371,2490,483,662,15,4,3654,42552,7805,7076,173,59,57665
LGA12900,0,4,0,24,156,9,20,24,0,209,3315,126,179,80,3,3703
LGA12950,0,4,0,25,96,0,11,22,0,129,1573,6,116,55,0,1750
LGA13010,0,0,0,40,196,11,11,3,0,221,3389,130,75,27,7,3628
LGA13050,0,0,0,13,77,3,8,10,0,98,1896,25,84,80,0,2085
LGA13100,182,8,3,1006,2313,756,599,112,23,3803,48199,9128,5702,745,137,63911
LGA13310,3,3,0,72,432,33,42,38,0,545,9540,607,494,220,25,10886
LGA13320,5,15,3,213,560,164,150,125,0,999,11193,1911,1509,645,18,15276
LGA13340,4,0,0,41,221,10,0,11,0,242,3662,42,32,41,8,3785
LGA13380,24,5,0,144,808,61,142,38,0,1049,16172,1128,1276,344,19,18939
LGA13450,3,3,0,65,515,56,103,22,0,696,7631,570,667,89,0,8957
LGA13500,0,3,0,24,57,3,7,6,0,73,1317,23,56,58,0,1454
LGA13550,0,3,0,53,242,14,23,38,0,317,4191,136,328,93,3,4751
LGA13650,0,0,0,26,84,5,0,17,0,106,1596,32,27,30,0,1685
LGA13660,0,0,0,37,78,0,7,0,0,85,1968,4,47,51,3,2073
LGA13700,0,0,0,19,55,4,0,4,0,63,1409,27,21,29,0,1486
LGA13800,15,5,0,148,951,124,66,65,0,1206,18595,2020,806,304,18,21743
LGA13850,0,0,0,10,47,0,16,7,0,70,1108,3,82,60,3,1256
LGA13950,51,0,0,259,1101,314,900,18,0,2333,20979,4921,8611,82,20,34613
LGA14000,267,4,0,786,1004,159,555,50,3,1771,40470,4116,9107,223,37,53953
LGA14100,19,0,0,56,110,20,69,4,0,203,3002,461,1135,37,0,4635
LGA14150,37,0,0,179,666,184,504,16,0,1370,16619,3475,8145,155,12,28406
LGA14200,4,3,0,67,248,3,42,7,0,300,5615,78,479,124,0,6296
LGA14250,0,0,0,11,39,0,3,0,0,42,548,7,20,3,3,581
LGA14300,0,0,3,17,109,5,3,3,6,126,1876,55,13,13,20,1977
LGA14350,0,8,0,66,501,40,51,53,0,645,9856,572,546,394,6,11374
LGA14400,96,3,0,130,208,29,55,20,0,312,6188,678,678,130,3,7677
LGA14450,63,0,3,131,438,91,444,7,0,980,11141,1677,7099,81,19,20017
LGA14500,172,0,3,354,901,108,444,3,3,1459,29074,1575,6208,27,55,36939
LGA14550,3,3,0,32,187,7,5,11,0,210,3586,36,67,74,0,3763
LGA14600,0,3,0,32,141,3,7,8,0,159,2462,38,55,56,0,2611
LGA14650,183,7,0,625,2268,327,323,133,0,3051,62240,5264,3920,841,36,72301
LGA14700,79,3,3,110,180,39,324,4,3,550,6055,740,5459,38,45,12337
LGA14750,6,0,0,23,227,16,59,8,0,310,3534,176,280,47,0,4037
LGA14800,36,0,0,90,334,452,593,46,4,1429,7803,8204,6315,295,22,22639
LGA14850,15,4,0,134,561,82,94,77,0,814,14298,958,1276,414,13,16959
LGA14870,0,0,0,65,415,32,32,49,5,533,7310,436,253,107,10,8116
LGA14900,29,3,3,300,2488,585,1188,13,6,4280,41968,6664,7693,97,49,56471
LGA14920,0,0,0,29,135,0,3,6,0,144,2911,45,55,26,12,3049
LGA14950,0,0,0,7,63,0,0,3,0,66,1128,0,10,13,6,1157
LGA15050,40,0,0,149,800,114,127,46,0,1087,21795,1558,1279,199,4,24835
LGA15150,46,0,0,80,251,113,785,37,0,1186,6336,1895,7924,83,18,16256
LGA15200,37,3,3,139,636,608,1274,62,0,2580,10512,8781,12289,447,70,32099
LGA15270,0,0,0,61,465,47,48,93,0,653,8003,344,337,241,3,8928
LGA15300,3,7,3,59,367,41,74,32,0,514,4377,172,450,210,11,5220
LGA15350,59,3,0,95,244,83,611,5,4,947,4405,1428,5747,18,52,11650
LGA15500,10,3,0,61,130,4,27,17,0,178,2487,26,243,100,11,2867
LGA15550,0,0,0,11,52,0,0,3,0,55,808,0,42,27,0,877
LGA15650,3,3,0,45,323,31,46,45,0,445,5207,245,369,155,19,5995
LGA15700,11,0,0,67,325,47,55,101,0,528,6751,370,568,303,0,7992
LGA15750,9,0,0,57,281,4,38,45,0,368,4460,43,434,176,14,5127
LGA15800,0,0,0,23,157,3,19,34,0,213,2185,35,106,61,5,2392
LGA15850,0,0,0,25,138,0,8,6,0,152,2373,46,88,37,0,2544
LGA15900,101,3,0,431,1941,496,894,77,8,3416,44165,7443,8883,299,90,60880
LGA15950,94,0,0,130,225,292,2271,23,7,2818,4160,4453,22569,127,57,31366
LGA16100,0,0,0,11,91,5,3,0,0,99,1858,40,46,23,0,1967
LGA16150,20,3,0,92,634,97,77,82,0,890,12462,1066,930,176,11,14645
LGA16180,0,3,0,32,282,14,3,50,0,349,4885,81,18,217,4,5205
LGA16200,0,3,0,60,369,22,31,48,0,470,5254,201,214,115,6,5790
LGA16250,324,4,0,590,1663,488,1923,72,8,4154,30967,7967,20542,186,106,59768
LGA16350,27,5,30,286,2209,424,459,68,33,3193,49815,6718,4574,290,104,61501
LGA16370,101,3,0,264,622,142,233,36,0,1033,15149,2238,2983,207,12,20589
LGA16380,86,63,0,544,920,215,378,108,6,1627,22572,3444,3299,1114,25,30454
LGA16400,20,15,0,257,1033,204,192,89,0,1518,20477,2761,1295,677,22,25232
LGA16470,19,3,0,91,436,123,283,46,0,888,9825,2265,2675,119,11,14895
LGA16550,175,4,3,303,871,493,2905,29,5,4303,15152,7783,28062,229,65,51291
LGA16610,22,5,0,80,363,31,56,38,3,491,7369,489,707,441,6,9012
LGA16650,71,3,0,193,1027,248,1349,80,7,2711,17621,4573,13759,345,62,36360
LGA16700,186,3,3,350,827,246,834,19,4,1930,20385,5866,12746,133,28,39158
LGA16900,24,5,0,149,693,132,89,33,0,947,18831,2566,1216,385,3,23001
LGA16950,43,7,9,350,1848,178,165,112,8,2311,33262,1971,1625,833,61,37752
LGA17000,3,3,0,48,303,29,32,24,0,388,7151,450,389,170,4,8164
LGA17050,10,3,5,44,196,53,98,122,465,934,2101,370,490,192,526,3679
LGA17100,17,0,0,78,392,65,608,0,0,1065,5840,955,5342,37,6,12180
LGA17150,255,3,0,538,1540,489,1443,53,0,3525,51339,8891,17160,378,19,77787
LGA17200,292,0,24,452,296,1717,8989,546,67,11615,3309,17032,63431,790,589,85151
LGA17310,4,3,3,181,899,127,205,99,4,1334,19059,966,1654,293,37,22009
LGA17350,0,0,0,23,96,3,9,5,0,113,2181,15,122,33,6,2357
LGA17400,3,3,0,41,171,3,5,13,0,192,2625,38,76,119,9,2867
LGA17420,49,0,6,348,1255,244,206,3,0,1708,45663,5851,2853,64,64,54495
LGA17450,0,0,0,16,62,0,5,12,0,79,1273,0,36,30,0,1339
LGA17500,6,0,0,34,199,13,24,19,17,272,3970,84,278,65,17,4414
LGA17550,65,22,3,371,1108,435,456,188,7,2194,22703,6875,4619,1626,58,35881
LGA17620,3,3,3,68,272,12,24,14,3,325,5017,116,223,146,12,5514
LGA17640,0,3,3,37,135,3,3,3,0,144,2809,42,18,43,3,2915
LGA17650,3,0,0,25,84,3,3,0,0,90,2158,9,66,42,0,2275
LGA17700,0,0,0,4,37,0,0,3,0,40,462,0,0,7,0,469
LGA17750,55,3,0,195,676,68,184,43,0,971,18780,989,2352,204,20,22345
LGA17800,3,0,0,21,116,0,6,16,0,138,1477,11,91,60,3,1642
LGA17850,0,3,0,26,52,3,3,15,0,73,1180,14,34,36,0,1264
LGA17900,0,25,0,87,231,3,20,69,0,323,2320,25,126,432,19,2922
LGA17950,0,0,0,17,53,0,5,3,0,61,1037,34,42,36,0,1149
LGA18000,365,0,3,706,1017,206,1276,23,3,2525,31359,3234,17655,147,43,52438
LGA18020,6,3,0,53,239,0,21,37,0,297,3621,26,129,110,14,3900
LGA18050,101,0,0,140,384,427,2622,37,4,3474,5274,5026,17472,191,64,28027
LGA18100,0,0,0,13,75,4,4,0,0,83,1439,35,63,8,0,1545
LGA18150,0,0,0,27,172,5,8,7,4,196,2985,60,113,54,4,3216
LGA18200,0,3,0,27,168,3,9,30,0,210,2374,35,103,217,5,2734
LGA18250,155,0,0,233,464,88,803,7,0,1362,12655,2002,11276,61,4,25998
LGA18350,21,4,0,164,700,82,28,20,4,834,15615,1244,319,136,23,17337
LGA18400,9,3,0,114,630,21,25,29,0,705,13570,431,237,132,3,14373
LGA18450,204,18,0,604,2159,516,1171,182,0,4028,52301,8552,12588,910,50,74401
LGA18500,138,0,0,189,461,500,1680,14,3,2658,5318,5064,12419,78,51,22930
LGA18550,155,8,0,531,2233,345,391,166,0,3135,48089,5288,3524,923,31,57855
LGA18710,0,0,0,49,262,11,8,20,0,301,5117,171,64,75,0,5427
LGA18750,15,0,0,51,269,16,23,3,0,311,4313,188,235,39,6,4781
LGA19399,0,3,0,19,16,0,3,12,0,31,384,0,17,62,3,466
LGA20110,4,0,0,57,216,8,20,16,0,260,4688,147,196,104,13,5148
LGA20260,5,0,0,40,198,0,16,8,0,222,4173,73,189,52,0,4487
LGA20570,25,3,0,264,1484,168,260,32,3,1947,31697,2247,2883,222,12,37061
LGA20660,21,0,0,272,1415,215,313,13,3,1959,36208,4516,4143,63,11,44941
LGA20740,0,3,0,91,724,42,81,41,0,888,11614,596,586,219,11,13026
LGA20830,5,3,0,108,671,63,37,32,0,803,14734,1007,554,192,3,16490
LGA20910,81,0,0,257,1009,344,460,14,0,1827,23674,5828,5025,120,22,34669
LGA21010,10,0,0,70,176,29,21,9,0,235,5018,314,287,70,0,5689
LGA21110,89,0,0,352,1342,426,1059,23,0,2850,37282,8671,13355,260,25,59593
LGA21180,46,3,0,361,4004,316,569,42,0,4931,53463,3145,4810,147,17,61582
LGA21270,0,0,3,34,109,5,4,4,0,122,2543,52,61,32,6,2694
LGA21370,50,0,0,123,626,31,111,17,0,785,12596,441,1069,217,11,14334
LGA21450,169,3,0,294,1071,96,50,19,0,1236,23792,1089,804,207,9,25901
LGA21610,109,5,0,573,3414,234,291,31,3,3973,75585,3689,3253,172,18,82717
LGA21670,9,0,0,35,272,15,14,16,0,317,4871,163,247,127,0,5408
LGA21750,0,0,0,74,364,34,31,36,0,465,7326,388,356,103,0,8173
LGA21830,0,3,3,75,271,4,18,16,0,309,6053,61,190,86,6,6396
LGA21890,56,3,0,289,2161,537,1082,74,0,3854,35584,7157,11044,394,21,54200
LGA22110,5,9,0,142,711,44,102,82,3,942,15330,629,1120,578,14,17671
LGA22170,320,3,0,575,2137,276,457,89,0,2959,40390,3428,4997,505,13,49333
LGA22250,0,3,0,34,237,13,13,24,0,287,4035,68,150,100,3,4356
LGA22310,127,0,0,351,1217,500,1108,47,0,2872,28974,8779,13820,292,32,51897
LGA22410,0,0,0,37,381,15,36,22,0,454,7291,283,349,107,6,8036
LGA22490,0,0,0,37,270,10,0,6,0,286,6382,24,25,42,4,6477
LGA22620,18,7,0,221,1640,134,218,67,5,2064,35244,1589,2366,423,16,39638
LGA22670,122,6,4,408,2074,266,867,109,5,3321,32276,3978,10099,703,32,47088
LGA22750,151,17,3,685,3183,266,652,152,0,4253,70717,4241,7633,780,23,83394
LGA22830,45,6,0,231,1126,70,209,85,0,1490,19589,777,1905,509,20,22800
LGA22910,7,4,0,57,330,8,11,10,0,359,5754,100,134,81,0,6069
LGA22980,0,0,0,22,109,0,4,3,0,116,2265,4,97,45,0,2411
LGA23110,15,4,0,142,1421,254,313,30,0,2018,24706,4069,3510,234,9,32528
LGA23190,0,5,0,55,282,25,46,37,0,390,6857,401,545,103,0,7906
LGA23270,9,3,0,285,2746,351,232,43,4,3376,47030,4637,2279,299,29,54274
LGA23350,7,3,0,44,230,8,7,17,0,262,5415,142,165,117,0,5839
LGA23430,113,3,0,405,1668,619,710,45,0,3042,36845,9471,8508,487,12,55323
LGA23670,140,6,0,721,1485,281,122,19,0,1907,46217,4552,2120,216,10,53115
LGA23810,88,5,0,197,1388,77,309,30,0,1804,25053,1015,2734,309,7,29118
LGA23940,3,7,0,47,196,0,3,43,0,242,3027,7,57,138,0,3229
LGA24130,3,0,0,90,621,17,40,6,0,684,14339,192,437,92,3,15063
LGA24210,84,0,0,398,1122,220,164,6,0,1512,32505,4565,2380,70,3,39523
LGA24250,0,4,0,38,163,9,8,6,0,186,2860,196,50,49,5,3160
LGA24330,52,3,0,160,1239,326,966,27,7,2565,17388,4175,6761,159,38,28521
LGA24410,31,0,0,226,974,363,97,24,0,1458,30259,7022,1875,74,9,39239
LGA24600,168,7,0,233,112,648,4600,149,3,5512,2135,7260,37076,244,44,46759
LGA24650,17,0,0,286,1720,189,99,30,4,2042,32679,2528,912,168,11,36298
LGA24780,26,10,0,174,987,125,183,131,0,1426,17070,1085,1603,618,14,20390
LGA24850,10,3,3,89,689,50,34,43,0,816,11273,492,484,178,3,12430
LGA24900,14,5,4,111,574,45,81,42,0,742,9888,364,777,273,16,11318
LGA24970,244,3,0,543,2012,414,527,18,3,2974,47584,7197,6369,110,36,61296
LGA25060,54,0,0,218,1407,283,1059,28,0,2777,27814,5059,9401,136,18,42428
LGA25150,7,3,0,68,496,12,36,16,0,560,9778,107,470,100,0,10455
LGA25250,57,3,0,312,2226,695,1053,52,4,4030,37472,9958,10802,314,37,58583
LGA25340,64,6,3,629,2606,424,261,51,3,3345,48021,5169,2671,616,25,56502
LGA25430,3,3,0,56,356,16,30,11,0,413,6892,140,263,96,6,7397
LGA25490,0,3,0,71,287,10,5,10,0,312,5794,139,42,76,0,6051
LGA25620,0,7,0,43,323,5,4,24,0,356,5014,65,39,236,7,5361
LGA25710,4,0,0,91,556,37,27,0,0,620,18798,591,375,31,9,19804
LGA25810,3,3,0,41,215,6,12,45,0,278,4566,140,153,126,4,4989
LGA25900,125,0,0,202,423,545,2885,154,3,4010,6859,9126,29615,385,23,46008
LGA25990,0,0,0,23,148,0,0,8,0,156,2685,8,30,56,3,2782
LGA26080,0,0,0,0,76,7,3,3,0,89,1164,105,31,16,0,1316
LGA26170,12,3,0,113,485,28,33,22,0,568,10240,268,255,122,3,10888
LGA26260,3,3,0,72,280,5,28,13,0,326,6262,84,328,106,0,6780
LGA26350,156,0,0,283,809,502,1942,29,0,3282,15183,7363,19399,174,29,42148
LGA26430,6,3,0,44,236,5,16,46,4,307,3669,44,158,197,4,4072
LGA26490,7,3,0,63,433,30,50,23,0,536,8597,452,483,86,12,9630
LGA26610,0,8,0,58,422,25,57,95,0,599,6840,232,612,315,9,8008
LGA26670,0,0,0,22,95,4,3,4,0,106,2284,36,22,36,0,2378
LGA26700,3,0,0,93,385,30,59,19,0,493,9675,384,726,159,4,10948
LGA26730,63,4,0,143,470,59,129,54,0,712,10191,768,1452,171,0,12582
LGA26810,9,3,0,158,759,64,57,41,0,921,14863,660,610,205,6,16344
LGA26890,3,0,0,32,77,0,0,10,0,87,1728,9,53,27,0,1817
LGA26980,173,0,0,666,1595,488,563,14,4,2664,42789,8644,5688,64,23,57208
LGA27070,46,0,0,293,2325,167,163,0,0,2655,46328,3226,2111,39,9,51713
LGA27170,3,3,0,68,429,66,72,18,0,585,11201,1084,1237,103,0,13625
LGA27260,42,0,0,320,2574,205,196,49,0,3024,49444,3068,2311,190,9,55022
LGA27350,66,11,0,207,367,993,1414,111,7,2892,6959,13630,12573,328,34,33524
LGA27450,70,5,3,428,2014,127,132,56,5,2334,48170,1891,1860,332,20,52273
LGA27630,0,4,0,30,177,5,0,5,0,187,2858,40,32,34,3,2967
LGA29399,37,0,6,52,4,8,68,0,0,80,76,65,453,9,15,618
LGA30250,0,0,0,3,3,0,0,0,0,3,224,0,3,6,0,233
LGA30300,0,3,0,35,121,7,15,17,0,160,1556,70,98,133,12,1869
LGA30370,3,4,0,84,289,0,19,54,0,362,4990,55,274,359,7,5685
LGA30410,4,0,0,22,83,4,3,23,3,116,1198,20,39,156,33,1446
LGA30450,0,3,0,6,5,0,0,8,3,16,119,3,8,51,14,195
LGA30760,5,0,0,19,40,0,3,43,0,86,816,18,50,95,9,988
LGA30900,0,3,3,14,14,0,3,3,0,20,145,3,15,28,9,200
LGA31000,862,18,5,3023,11300,2589,7214,506,16,21625,277907,38972,78649,2728,210,398466
LGA31750,0,5,3,8,10,0,0,7,3,20,125,3,0,60,11,199
LGA31820,22,23,0,533,1325,161,238,214,0,1938,29957,1987,2404,1842,17,36207
LGA31900,3,9,0,56,288,16,53,64,6,427,5922,225,441,408,11,7007
LGA31950,0,8,0,15,35,0,0,67,0,102,120,3,0,221,11,355
LGA32070,89,61,5,487,2614,570,1893,361,13,5451,43008,4822,13251,2357,117,63555
LGA32250,3,10,0,20,96,4,12,94,0,206,560,12,72,584,24,1252
LGA32260,0,37,0,102,516,18,128,163,4,829,9336,203,1073,1250,22,11884
LGA32270,0,64,0,208,687,29,89,204,8,1017,8599,307,685,1357,47,10995
LGA32310,3,12,0,57,306,10,24,60,0,400,4088,51,162,474,10,4785
LGA32330,0,0,0,0,3,0,0,0,0,3,214,0,38,0,0,252
LGA32450,0,13,0,31,119,12,6,54,0,191,911,46,33,245,18,1253
LGA32500,0,35,5,67,114,3,8,154,8,287,1234,33,101,545,42,1955
LGA32600,0,4,0,8,14,0,0,22,4,40,102,0,0,48,7,157
LGA32750,0,4,0,4,4,0,0,8,0,12,98,6,3,66,19,192
LGA32770,0,0,0,4,4,0,0,0,0,4,218,0,9,12,3,242
LGA33100,0,14,0,24,33,0,0,52,13,98,322,0,11,297,28,658
LGA33200,0,5,4,25,55,0,0,13,0,68,681,7,14,99,8,809
LGA33220,45,39,0,551,1473,77,272,234,4,2060,33260,1176,2877,2023,29,39365
LGA33360,7,16,0,111,1250,127,300,272,10,1959,18217,758,1572,1415,38,22000
LGA33430,557,62,3,1681,5981,2853,5389,462,45,14730,114322,36494,41248,3283,238,195585
LGA33610,3,5,3,73,269,6,46,51,3,375,3667,24,320,180,15,4206
LGA33620,15,16,4,136,840,22,108,142,0,1112,16504,364,823,834,21,18546
LGA33800,4,4,0,56,217,0,24,26,0,267,4233,57,297,300,6,4893
LGA33830,0,3,0,6,3,0,0,0,0,3,221,0,11,3,0,235
LGA33960,29,5,3,254,2602,218,170,58,3,3051,52976,3090,1875,452,66,58459
LGA33980,3,9,4,130,483,26,28,119,4,660,6529,398,242,713,33,7915
LGA34420,4,0,0,4,0,0,0,0,0,0,161,0,92,0,3,256
LGA34570,0,6,0,9,3,0,0,0,0,3,85,0,29,12,3,129
LGA34580,4,4,3,81,859,13,37,65,0,974,11781,166,372,241,3,12563
LGA34590,50,5,0,480,4226,649,344,65,5,5289,83009,8244,3010,566,37,94866
LGA34710,0,10,0,26,80,6,7,49,5,147,1436,43,91,388,70,2028
LGA34770,25,26,0,404,1567,193,375,214,3,2352,34016,2043,3307,1606,58,41030
LGA34800,0,0,3,16,20,0,0,16,3,39,306,0,0,62,20,388
LGA34830,0,0,0,3,3,0,0,0,0,3,65,0,7,20,0,92
LGA34860,4,5,0,73,373,7,34,39,7,460,4431,143,187,291,46,5098
LGA35010,142,23,0,1361,4912,686,670,237,3,6508,117339,10250,8084,1677,75,137425
LGA35250,3,3,0,11,5,0,3,0,0,8,235,0,22,10,0,267
LGA35300,4,25,4,65,716,69,251,328,7,1371,5473,408,1197,983,52,8113
LGA35600,0,5,3,26,117,7,6,21,3,154,1672,24,38,157,30,1921
LGA35670,0,0,0,0,0,0,0,0,0,0,135,0,40,4,3,182
LGA35760,0,8,0,61,266,4,33,196,0,499,3847,45,126,502,4,4524
LGA35780,0,24,0,24,7,0,4,33,0,44,386,0,129,246,6,767
LGA35790,3,3,0,6,0,0,3,3,0,6,293,0,78,25,0,396
LGA35800,0,10,0,20,58,0,0,12,0,70,729,3,21,122,23,898
LGA36070,0,0,0,4,0,0,0,0,0,0,129,0,37,0,0,166
LGA36150,0,0,0,12,12,0,3,5,3,23,356,9,20,60,15,460
LGA36250,40,7,0,665,1529,315,94,42,0,1980,43632,4866,1636,354,15,50503
LGA36300,0,0,0,11,32,4,11,8,0,55,313,13,14,54,9,403
LGA36360,31,36,0,392,2282,120,345,243,7,2997,35607,1274,3153,1728,39,41801
LGA36510,4,6,3,126,578,21,27,43,0,669,12863,304,347,267,12,13793
LGA36580,0,8,0,73,364,3,5,42,3,417,7734,42,107,266,6,8155
LGA36630,9,5,0,94,611,8,46,61,28,754,11337,71,713,320,49,12490
LGA36660,6,3,3,131,517,20,41,46,3,627,12165,281,681,188,28,13343
LGA36710,277,54,0,1993,3724,805,1305,358,4,6196,92355,12253,15243,3871,74,123796
LGA36810,4,27,3,183,953,21,100,167,5,1246,15265,330,911,1141,48,17695
LGA36910,161,9,6,606,2142,172,479,78,0,2871,48681,2398,5732,493,59,57363
LGA36950,3,3,3,28,74,27,26,9,0,136,551,177,189,51,3,971
LGA36960,0,3,0,10,39,0,0,0,0,39,912,0,48,22,0,982
LGA37010,92,16,0,558,2983,366,1070,223,8,4650,51590,3712,8777,1455,62,65596
LGA37300,3,4,0,10,65,21,27,24,0,137,715,218,200,109,0,1242
LGA37310,11,17,0,162,780,23,63,114,6,986,10946,175,463,470,24,12078
LGA37340,23,42,4,131,695,94,311,291,0,1391,8845,712,1976,1684,37,13254
LGA37400,0,5,0,16,25,0,0,29,3,57,487,13,18,181,39,738
LGA37550,0,0,0,3,5,0,0,0,3,8,179,0,45,0,3,227
LGA37570,0,0,0,3,0,0,0,0,0,0,58,0,15,0,0,73
LGA37600,0,6,0,11,3,0,0,3,0,6,348,0,35,42,0,425
LGA39399,0,0,0,0,0,0,0,0,0,0,0,0,0,0,0,0
LGA40070,51,0,0,90,66,251,647,103,3,1070,1088,3120,5085,127,19,9439
LGA40120,11,0,0,148,420,17,4,8,3,452,13414,340,100,41,12,13907
LGA40220,3,3,0,218,335,32,16,6,0,389,9088,414,188,147,5,9842
LGA40250,5,0,0,46,14,0,3,0,0,17,515,0,55,13,6,589
LGA40310,20,6,3,162,321,15,24,3,0,363,8066,337,292,92,12,8799
LGA40430,12,0,0,28,47,0,0,0,0,47,1010,3,44,35,3,1095
LGA40520,15,7,0,53,205,33,45,19,0,302,3730,276,306,107,7,4426
LGA40700,201,0,0,359,399,141,252,0,0,792,11701,2313,3133,16,5,17168
LGA40910,113,0,0,312,629,123,131,0,3,886,15171,2046,1916,9,9,19151
LGA41010,10,3,0,27,55,0,9,31,0,95,1210,6,82,148,11,1457
LGA41060,131,3,0,506,1458,440,443,25,0,2366,31460,6944,5357,167,12,43940
LGA41140,0,3,0,24,126,3,14,8,0,151,3302,66,87,75,3,3533
LGA41190,0,0,0,10,19,0,0,0,0,19,681,3,0,21,3,708
LGA41330,0,0,0,13,104,0,0,0,3,107,756,21,10,45,8,840
LGA41560,5,3,0,80,179,22,18,7,0,226,5086,271,122,99,3,5581
LGA41750,0,0,0,11,10,0,0,8,0,18,412,0,13,66,3,494
LGA41830,0,5,0,8,35,0,4,30,0,69,667,9,21,83,10,790
LGA41960,7,0,0,7,38,0,4,11,0,53,484,9,23,36,0,552
LGA42030,0,0,0,153,305,77,19,18,0,419,7231,895,255,78,9,8468
LGA42110,0,0,0,14,81,0,0,5,3,89,1667,51,17,37,3,1775
LGA42250,0,0,0,35,110,0,0,3,0,113,2745,12,17,40,7,2821
LGA42600,187,0,3,322,313,161,552,6,0,1032,8127,2911,4475,60,9,15582
LGA42750,4,3,0,26,96,3,8,9,0,116,1810,20,73,41,0,1944
LGA43080,0,0,0,6,23,0,0,6,0,29,411,0,0,19,0,430
LGA43220,0,0,0,12,19,0,3,0,0,22,415,4,6,0,4,429
LGA43360,0,0,0,16,56,0,0,5,0,61,901,23,29,21,0,974
LGA43650,4,0,0,23,155,0,3,0,0,158,4793,52,48,11,3,4907
LGA43710,3,3,0,20,50,0,0,0,0,50,1690,19,22,61,3,1795
LGA43790,7,0,0,73,164,11,17,34,0,226,4158,237,135,143,0,4673
LGA43920,0,0,0,22,126,0,0,4,0,130,2945,18,21,32,0,3016
LGA44000,0,0,0,0,3,0,0,0,0,3,14,0,9,0,7,30
LGA44060,67,0,0,389,954,374,250,4,0,1582,25355,6090,3324,23,5,34797
LGA44210,0,0,0,38,234,6,0,13,21,274,3264,119,15,122,38,3558
LGA44340,140,3,0,518,635,93,155,8,3,894,19990,1722,2525,78,6,24321
LGA44550,21,3,0,149,334,22,31,9,0,396,10372,341,381,84,3,11181
LGA44620,23,3,0,218,266,41,77,11,3,398,8507,689,1247,67,3,10513
LGA44830,7,0,0,26,64,4,0,17,0,85,1165,7,18,65,0,1255
LGA45040,17,4,0,146,395,61,25,11,3,495,6783,672,275,93,8,7831
LGA45090,10,3,3,44,129,3,14,9,0,155,3022,36,132,42,3,3235
LGA45120,3,3,0,27,52,5,0,4,0,61,1805,43,11,47,0,1906
LGA45290,143,0,0,393,335,245,256,15,0,851,8414,3660,3506,45,6,15631
LGA45340,79,8,3,1032,2141,253,167,42,0,2603,55973,3510,2303,406,33,62225
LGA45400,0,0,0,6,18,0,0,0,4,22,357,0,3,14,10,384
LGA45540,0,0,0,3,54,3,0,7,0,64,781,6,18,39,0,844
LGA45680,29,3,3,140,1212,390,111,16,0,1729,24175,4453,1267,128,6,30029
LGA45890,109,3,3,476,1785,479,470,18,3,2755,33669,7169,5292,179,31,46340
LGA46090,0,6,0,29,354,64,60,34,3,515,4662,463,290,224,13,5652
LGA46300,7,0,0,57,190,48,60,64,0,362,4284,875,490,103,4,5756
LGA46450,11,3,0,40,238,45,29,11,0,323,6070,691,367,103,4,7235
LGA46510,33,3,0,74,245,62,77,0,0,384,5852,920,1280,10,6,8068
LGA46670,9,0,0,36,210,10,20,114,0,354,3325,117,246,148,16,3852
LGA46860,0,0,0,7,40,6,0,0,0,46,562,22,15,20,0,619
LGA46970,0,0,3,9,57,10,16,5,0,88,1189,124,105,49,9,1476
LGA47140,29,4,0,493,2054,330,315,11,0,2710,41340,4539,2999,150,18,49046
LGA47290,0,0,0,18,28,0,0,3,0,31,836,0,21,10,0,867
LGA47490,0,0,0,12,44,0,0,14,3,61,754,9,24,85,3,875
LGA47630,4,3,0,71,62,3,4,10,3,82,2400,61,29,67,7,2564
LGA47700,69,0,0,744,1040,127,64,0,0,1231,32875,2699,1112,3,9,36698
LGA47800,0,7,0,43,178,16,4,10,0,208,2160,51,20,70,0,2301
LGA47910,0,0,0,3,28,0,3,26,0,57,969,36,47,29,3,1084
LGA47980,99,0,0,299,340,179,195,4,0,718,9154,3050,2998,8,9,15219
LGA48050,6,0,0,207,355,44,26,8,0,433,5392,436,258,55,0,6141
LGA48130,0,0,3,36,116,9,0,5,0,130,2548,48,19,36,6,2657
LGA48260,23,0,0,48,128,47,25,10,3,213,2158,349,344,63,3,2917
LGA48340,0,0,0,34,174,7,17,3,0,201,4346,152,164,49,7,4718
LGA48410,128,0,0,404,681,189,398,4,3,1275,15445,3064,5284,23,14,23830
LGA48540,4,3,0,28,382,199,45,48,0,674,6313,2648,437,144,5,9547
LGA48640,0,0,0,8,16,0,0,0,0,16,495,0,0,11,0,506
LGA48750,3,0,0,22,80,4,3,9,0,96,1828,42,49,44,3,1966
LGA48830,7,0,0,63,171,12,10,23,0,216,4578,80,78,244,0,4980
LGA49399,0,27,26,77,227,3,22,161,14,427,1398,15,100,463,142,2118
LGA50080,35,5,0,151,448,52,60,63,0,623,11520,771,521,260,7,13079
LGA50210,12,0,0,208,1147,116,104,24,0,1391,20399,1370,1117,131,8,23025
LGA50250,3,20,8,61,127,19,6,168,8,328,1828,194,46,671,62,2801
LGA50280,11,5,0,60,327,20,8,32,3,390,4249,224,66,171,7,4717
LGA50350,13,0,0,53,244,41,36,5,0,326,4784,588,556,9,0,5937
LGA50420,40,0,0,196,839,347,357,9,0,1552,17297,4605,3566,16,17,25501
LGA50490,40,0,3,99,806,205,159,13,0,1183,10587,2226,1738,60,20,14631
LGA50560,0,0,0,6,22,8,0,0,0,30,651,18,3,15,0,687
LGA50630,0,0,0,5,33,4,0,0,0,37,552,26,19,22,0,619
LGA50770,0,0,0,4,24,0,0,0,0,24,627,3,0,0,4,634
LGA50840,0,0,0,25,44,3,0,8,0,55,1684,54,7,28,4,1777
LGA50910,0,0,0,7,24,3,0,5,0,32,325,27,0,11,0,363
LGA50980,7,42,9,100,382,73,69,255,11,790,3633,544,448,2387,109,7121
LGA51080,0,0,0,3,15,0,0,3,0,18,395,5,4,10,0,414
LGA51120,0,0,0,3,18,0,0,0,0,18,381,0,22,3,0,406
LGA51190,13,5,0,165,627,177,89,13,0,906,10041,1941,933,198,8,13121
LGA51260,20,13,0,151,478,41,26,46,0,591,10088,844,349,299,16,11596
LGA51310,39,3,0,199,262,72,86,3,0,423,7363,965,965,6,12,9311
LGA51330,101,0,0,320,1015,392,245,3,0,1655,24704,4080,2444,36,8,31272
LGA51400,0,0,0,27,220,0,8,0,0,228,4787,11,37,20,10,4865
LGA51470,0,0,0,3,24,0,0,0,0,24,233,9,0,5,0,247
LGA51540,0,29,4,52,182,41,13,222,4,462,1678,181,71,1441,53,3424
LGA51610,0,0,0,5,25,0,0,8,0,33,414,9,0,60,3,486
LGA51680,0,3,0,19,72,0,0,3,3,78,1512,20,0,36,6,1574
LGA51750,75,0,0,113,121,43,109,0,0,273,2446,416,970,0,4,3836
LGA51820,9,4,3,189,1222,204,156,49,0,1631,28378,2962,1563,162,9,33074
LGA51890,0,0,0,13,147,7,11,4,0,169,3193,83,88,66,0,3430
LGA51960,0,5,0,10,151,14,8,16,3,192,1233,68,69,69,6,1445
LGA52030,0,0,0,8,28,0,0,0,0,28,439,0,12,29,0,480
LGA52100,0,0,0,6,14,0,0,0,0,14,421,7,21,7,0,456
LGA52170,5,0,0,16,164,28,110,0,3,305,2066,343,668,0,3,3080
LGA52240,0,0,0,5,27,0,0,0,0,27,428,8,0,0,0,436
LGA52310,0,0,0,3,10,0,0,0,0,10,341,0,0,12,0,353
LGA52380,0,0,0,4,13,0,0,19,0,32,105,0,0,76,0,181
LGA52450,0,0,0,7,24,3,0,0,0,27,481,15,6,10,0,512
LGA52520,0,0,0,3,15,0,0,4,0,19,484,3,0,16,3,506
LGA52590,3,4,0,22,129,0,0,23,0,152,1195,19,24,137,12,1387
LGA52660,0,0,0,85,170,9,0,53,0,232,4104,216,27,116,0,4463
LGA52730,0,3,0,42,80,8,0,13,0,101,2015,96,8,62,0,2181
LGA52800,3,44,18,82,215,24,7,208,16,470,1683,88,76,737,141,2725
LGA52870,0,0,0,11,95,0,3,7,0,105,1987,6,35,22,3,2053
LGA52940,0,0,0,5,10,0,0,0,0,10,278,0,9,0,3,290
LGA53010,0,0,0,3,4,4,0,0,0,8,254,4,0,6,0,264
LGA53080,0,0,3,8,36,3,0,26,3,68,350,10,3,116,34,513
LGA53150,0,0,0,4,83,37,50,0,0,170,1923,453,366,4,3,2749
LGA53220,4,9,3,50,270,26,33,36,7,372,1764,107,162,161,98,2292
LGA53290,0,4,0,49,287,17,29,39,4,376,4301,366,255,248,18,5188
LGA53360,0,13,4,24,69,6,8,57,0,140,776,65,85,996,17,1939
LGA53430,10,0,3,100,375,197,244,102,0,918,7322,2499,1750,309,9,11889
LGA53520,11,10,0,79,570,88,91,98,3,850,11686,776,858,537,26,13883
LGA53570,0,3,0,19,137,3,3,9,3,155,1755,21,41,56,12,1885
LGA53640,0,0,3,7,33,0,0,0,0,33,485,12,6,10,3,516
LGA53710,0,0,0,5,21,0,0,0,0,21,404,0,0,12,0,416
LGA53780,88,0,4,451,2022,133,167,6,0,2328,34329,1823,1479,162,18,37811
LGA53920,0,18,7,40,25,0,0,19,8,52,621,37,6,228,109,1001
LGA53990,10,5,0,51,452,9,14,114,3,592,7832,181,180,221,15,8429
LGA54060,0,3,0,12,52,4,4,17,3,80,1277,38,41,118,18,1492
LGA54130,0,0,0,7,25,3,0,3,0,31,391,18,3,19,0,431
LGA54170,50,0,0,287,1597,161,225,26,3,2012,49625,2763,1921,208,12,54529
LGA54200,19,3,0,252,907,65,20,14,0,1006,18496,805,237,138,5,19681
LGA54280,3,6,0,49,973,224,131,147,0,1475,8853,1160,788,524,40,11365
LGA54340,0,0,0,9,97,3,3,0,0,103,1449,40,76,15,0,1580
LGA54410,0,0,0,5,21,0,0,0,0,21,416,3,23,6,0,448
LGA54480,0,0,0,4,3,0,0,3,0,6,195,6,8,6,0,215
LGA54550,3,0,0,16,25,3,3,0,0,31,712,20,21,16,0,769
LGA54620,0,0,0,3,12,0,3,3,0,18,315,9,19,16,3,362
LGA54690,0,0,0,3,6,0,0,0,0,6,185,0,0,0,0,185
LGA54760,0,0,0,7,8,0,0,0,0,8,307,8,12,3,0,330
LGA54830,3,0,0,65,733,54,63,6,0,856,9652,509,469,10,9,10649
LGA54900,0,0,0,11,14,0,0,19,0,33,513,32,7,24,0,576
LGA54970,0,0,0,0,12,3,5,25,4,49,181,12,19,57,15,284
LGA55040,0,4,0,13,70,10,0,15,3,98,393,36,9,91,6,535
LGA55110,194,4,0,835,1245,302,191,64,0,1802,22462,3283,1676,381,13,27815
LGA55180,0,3,3,47,157,4,19,32,0,212,3387,29,191,85,15,3707
LGA55250,0,5,3,15,50,8,0,6,3,67,291,23,20,47,36,417
LGA55320,223,0,0,527,1136,298,238,3,0,1675,29547,4495,2762,10,28,36842
LGA55390,0,0,0,3,8,0,0,0,0,8,73,0,3,21,13,110
LGA55460,0,0,0,11,68,6,3,0,0,77,1170,72,20,43,5,1310
LGA55530,0,0,0,4,8,0,0,7,0,15,172,0,9,18,0,199
LGA55600,0,0,0,7,32,3,5,0,0,40,860,26,28,12,6,932
LGA55670,0,0,0,7,16,0,0,5,0,21,311,6,0,11,0,328
LGA55740,21,0,0,41,97,32,129,0,0,258,2104,441,1035,3,0,3583
LGA55810,0,0,0,0,16,0,0,3,3,22,207,0,0,27,6,240
LGA55880,0,0,0,5,6,0,0,0,0,6,200,0,0,7,0,207
LGA55950,0,0,0,3,0,0,0,0,0,0,192,18,3,10,0,223
LGA56020,0,0,0,3,23,0,0,5,0,28,242,0,7,30,3,282
LGA56090,5,0,0,79,741,18,6,27,0,792,12463,337,100,39,3,12942
LGA56160,0,0,0,4,6,0,0,0,0,6,42,3,0,3,0,48
LGA56230,5,3,0,170,323,21,7,42,0,393,5023,148,76,234,5,5486
LGA56300,0,7,0,11,22,3,0,5,0,30,506,8,0,50,0,564
LGA56370,0,0,0,7,15,0,0,0,0,15,313,9,10,3,0,335
LGA56450,0,0,0,4,17,0,0,0,0,17,297,0,0,0,0,297
LGA56520,7,0,0,12,70,6,10,0,0,86,1387,80,127,9,0,1603
LGA56580,76,0,0,146,202,44,50,0,0,296,6148,639,480,3,3,7273
LGA56620,0,3,0,18,12,0,6,5,0,23,349,0,22,21,14,406
LGA56730,4,0,0,25,315,10,21,9,0,355,3737,77,168,81,9,4072
LGA56790,0,10,0,30,78,4,3,41,0,126,1161,81,37,434,13,1726
LGA56860,0,0,0,3,3,0,0,0,0,3,94,0,0,0,0,94
LGA56930,0,0,0,3,29,3,19,0,0,51,417,9,109,0,0,535
LGA57000,0,3,0,6,4,0,0,0,0,4,198,0,0,12,0,210
LGA57080,28,3,0,34,21,84,1260,164,0,1529,186,685,8020,231,19,9141
LGA57140,0,0,0,6,20,0,0,0,0,20,430,3,21,8,0,462
LGA57210,4,0,0,27,112,9,0,5,3,129,1751,101,13,33,3,1901
LGA57280,0,14,3,51,638,151,125,288,10,1212,3260,706,476,664,54,5160
LGA57350,0,0,0,8,10,0,0,0,0,10,415,4,4,9,0,432
LGA57420,0,0,0,5,45,18,3,19,0,85,695,53,9,63,0,820
LGA57490,37,7,0,230,1716,168,205,59,3,2151,33341,2112,1999,409,11,37872
LGA57560,16,20,6,99,849,269,132,124,3,1377,4965,980,454,946,62,7407
LGA57630,0,0,3,3,10,0,0,7,3,20,45,0,0,28,6,79
LGA57700,0,3,0,28,257,5,0,3,0,265,5769,23,14,34,3,5843
LGA57770,0,5,0,15,6,3,3,63,0,75,279,24,49,477,3,832
LGA57840,83,0,0,267,468,326,435,0,8,1237,8695,4772,3993,0,11,17471
LGA57910,270,3,0,803,2563,1707,1379,31,0,5680,47717,22362,11489,191,25,81784
LGA57980,186,0,0,220,156,143,287,0,0,586,3276,1812,2983,17,17,8105
LGA58050,8,6,3,179,1802,196,187,109,3,2297,34088,2348,1463,395,46,38340
LGA58190,0,0,0,3,13,0,0,0,0,13,153,0,0,4,0,157
LGA58260,0,0,0,9,13,3,0,0,0,16,248,17,0,0,0,265
LGA58330,0,0,0,14,128,0,0,5,0,133,1703,18,6,43,3,1773
LGA58400,0,0,0,3,9,0,0,0,3,12,135,0,7,6,3,151
LGA58470,0,0,0,4,11,0,0,0,0,11,85,0,0,13,3,101
LGA58510,179,0,0,296,435,311,463,5,0,1214,7492,3093,3495,13,8,14101
LGA58540,0,0,0,5,17,0,0,5,0,22,356,6,3,13,0,378
LGA58570,11,3,0,103,465,269,453,45,0,1232,7624,2676,3571,89,11,13971
LGA58610,0,0,0,0,31,0,0,3,0,34,695,44,0,12,0,751
LGA58680,0,0,0,5,11,0,0,0,0,11,169,6,0,3,0,178
LGA58760,54,10,0,847,2314,239,116,42,0,2711,46954,3660,1018,347,3,51982
LGA58820,0,0,0,24,61,8,0,0,0,69,1257,94,9,23,3,1386
LGA58890,0,0,0,8,14,0,0,0,3,17,346,0,11,8,3,368
LGA59030,0,0,0,5,9,0,0,0,0,9,104,0,0,3,0,107
LGA59100,0,3,0,7,21,0,0,0,0,21,284,0,9,6,0,299
LGA59170,0,0,0,4,7,0,0,0,0,7,360,9,3,6,0,378
LGA59250,0,0,4,4,15,0,0,0,10,25,100,11,14,15,36,176
LGA59310,0,4,0,11,25,0,3,0,0,28,521,4,41,28,0,594
LGA59320,0,0,0,4,3,0,0,0,0,3,155,0,0,4,0,159
LGA59330,0,0,0,3,25,0,3,0,0,28,227,8,9,3,0,247
LGA59340,4,74,4,110,137,28,12,255,6,438,1757,182,122,1557,88,3706
LGA59350,0,0,0,3,14,0,0,0,0,14,64,0,0,12,3,79
LGA59360,0,0,0,13,38,3,4,8,0,53,468,40,4,27,10,549
LGA59370,0,0,0,14,81,3,0,3,0,87,1316,47,12,19,3,1397
LGA59399,0,0,0,0,0,0,0,0,0,0,0,0,0,0,3,3
LGA60210,0,0,0,26,146,6,3,3,0,158,2545,82,31,65,4,2727
LGA60410,3,0,0,22,297,8,32,0,0,337,5072,102,428,18,0,5620
LGA60610,3,0,0,27,258,27,48,4,3,340,6949,344,531,32,6,7862
LGA60810,21,3,0,87,328,16,56,29,0,429,7575,230,627,112,0,8544
LGA61010,0,0,0,12,43,4,0,10,0,57,853,90,6,26,0,975
LGA61210,4,0,0,32,136,3,13,3,0,155,2864,10,177,40,0,3091
LGA61410,27,0,0,140,706,95,92,10,0,903,18246,1114,986,82,6,20434
LGA61510,0,0,0,21,161,0,8,5,0,174,3551,52,139,28,0,3770
LGA61610,3,3,0,64,350,84,62,31,0,527,8562,809,572,129,12,10084
LGA61810,5,0,0,36,120,0,0,3,3,126,2645,3,128,17,3,2796
LGA62010,0,0,0,6,15,3,0,0,0,18,367,9,0,0,3,379
LGA62210,4,0,0,21,98,6,21,5,0,130,2440,41,184,23,3,2691
LGA62410,3,3,0,19,92,3,3,4,0,102,1648,68,40,73,0,1829
LGA62610,25,0,0,105,661,82,177,4,0,924,14860,1346,2552,75,0,18833
LGA62810,88,0,3,257,527,140,383,50,3,1103,13815,2272,4301,191,43,20622
LGA63010,0,3,0,53,193,13,3,11,0,220,5722,99,53,110,0,5984
LGA63210,0,0,0,16,73,3,0,3,0,79,2220,39,18,36,3,2316
LGA63410,0,0,0,9,37,0,0,0,0,37,688,10,12,3,0,713
LGA63610,15,0,0,99,363,28,40,4,0,435,11602,525,802,69,3,13001
LGA63810,0,0,0,30,126,10,7,3,0,146,3519,189,136,43,6,3893
LGA64010,95,3,0,240,967,156,191,44,4,1362,21628,1879,2688,185,25,26405
LGA64210,0,0,3,52,242,20,20,8,0,290,6669,475,308,50,3,7505
LGA64610,0,0,0,34,194,7,6,3,0,210,4653,114,95,50,0,4912
LGA64810,0,0,0,25,236,9,11,3,0,259,5021,182,103,20,4,5330
LGA65010,0,0,0,31,123,0,4,3,0,130,2295,0,42,13,3,2353
LGA65210,0,0,0,5,65,0,0,6,0,71,972,9,10,22,0,1013
LGA65410,5,3,0,41,182,29,19,4,0,234,4830,384,246,61,0,5521
LGA65610,5,0,0,18,130,3,10,11,0,154,1985,20,110,35,0,2150
LGA65810,3,3,0,63,303,26,8,10,0,347,7898,358,184,80,6,8526
LGA69399,0,0,0,0,0,0,0,0,0,0,0,0,0,0,0,0
LGA70200,6,20,3,103,434,165,243,215,9,1066,5769,1338,1593,995,54,9749
LGA70420,0,31,3,59,131,17,22,116,4,290,1299,81,133,441,40,1994
LGA70540,0,0,0,0,0,0,0,0,0,0,24,0,8,0,0,32
LGA70620,0,10,0,33,42,0,3,14,0,59,654,0,23,82,26,785
LGA70700,0,8,4,20,77,0,0,21,0,98,425,0,9,162,20,616
LGA71000,22,38,8,164,1268,531,1209,296,11,3315,14364,4286,7773,1271,116,27810
LGA71300,0,0,3,37,37,0,0,0,3,40,1186,0,39,12,26,1263
LGA72200,0,26,3,42,200,57,103,162,5,527,2225,304,323,640,37,3529
LGA72300,3,20,0,64,753,36,15,251,0,1055,5515,247,100,1243,16,7121
LGA72330,5,19,3,51,108,0,4,55,9,176,967,0,60,308,42,1377
LGA72800,0,11,0,33,641,100,129,22,0,892,7387,1032,1121,60,11,9611
LGA73600,4,19,8,47,95,0,17,94,9,215,1008,0,71,644,77,1800
LGA74050,5,0,0,17,17,0,4,0,0,21,499,0,68,8,0,575
LGA74500,5,25,4,56,56,0,8,56,4,124,1036,0,113,327,30,1506
LGA74560,0,0,0,3,12,0,0,3,0,15,156,0,0,21,0,177
LGA74660,3,25,3,56,57,0,23,95,6,181,912,16,156,414,38,1536
LGA79399,24,18,10,91,79,78,117,165,8,447,1436,476,512,626,60,3110
LGA89399,198,13,0,881,3028,1022,1726,94,3,5873,96769,19660,18159,394,55,135037
LGA99399,0,0,0,30,24,8,61,7,0,100,432,81,263,23,15,814
