region_id,C11_350_449_CF_CU15_NDS,C11_350_449_CF_NCU15_DS,C11_350_449_CF_NDCO,C11_350_449_CF_T,C11_450_549_CF_NC,C11_450_549_CF_Cu15DS_,C11_450_549_CF_CU15_NDS,C11_450_549_CF_NCU15_DS,C11_450_549_CF_NDCO,C11_450_549_CF_T,C11_550_649_CF_NC,C11_550_649_CF_Cu15DS_,C11_550_649_CF_CU15_NDS,C11_550_649_CF_NCU15_DS,C11_550_649_CF_NDCO,C11_550_649_CF_T,C11_650ov_CF_NC,C11_650ov_CF_Cu15DS_,C11_650ov_CF_CU15_NDS,C11_650ov_CF_NCU15_DS,C11_650ov_CF_NDCO,C11_650ov_CF_T,C11_Rns_CF_NC,C11_Rns_CF_Cu15DS_,C11_Rns_CF_CU15_NDS,C11_Rns_CF_NCU15_DS,C11_Rns_CF_NDCO,C11_Rns_CF_T,C11_Tot_CF_NC,C11_Tot_CF_Cu15DS_,C11_Tot_CF_CU15_NDS,C11_Tot_CF_NCU15_DS,C11_Tot_CF_NDCO,C11_Tot_CF_Tot
LGA10050,85,14,10,165,7,3,23,0,5,38,3,0,10,0,0,13,4,0,7,0,3,14,24,0,18,3,3,48,937,93,765,72,73,1940
LGA10110,85,8,8,155,0,3,9,4,0,16,0,0,3,0,0,3,4,0,0,0,0,4,12,0,14,0,4,30,482,59,468,39,51,1099
LGA10150,393,41,29,1266,249,12,168,15,19,463,69,4,79,5,6,163,38,12,80,12,10,152,31,0,6,5,3,45,1707,83,976,104,94,2964
LGA10200,768,88,77,1662,411,76,358,49,41,935,91,20,121,29,20,281,43,12,76,16,10,157,62,13,65,9,14,163,1989,382,2266,292,276,5205
LGA10250,291,27,34,588,43,15,85,9,5,157,13,3,13,3,0,32,10,0,10,0,0,20,6,3,17,0,3,29,802,118,711,70,99,1800
LGA10300,0,0,0,0,0,0,0,0,0,0,0,0,0,0,0,0,3,0,0,0,0,3,0,0,4,0,0,4,46,12,40,3,8,109
LGA10350,1447,189,207,2867,213,149,523,80,89,1054,46,35,139,9,22,251,21,15,62,8,7,113,99,26,111,32,32,300,2467,802,3597,539,658,8063
LGA10470,103,6,9,200,4,3,14,3,0,24,0,0,3,3,0,6,0,0,0,0,0,0,13,3,8,0,3,27,622,92,664,52,68,1498
LGA10550,34,4,0,79,3,3,3,0,0,9,0,0,0,0,0,0,4,0,6,0,0,10,14,3,16,3,3,39,519,71,452,50,53,1145
LGA10600,44,5,0,67,3,0,3,0,0,6,0,0,0,0,0,0,0,0,0,0,6,6,0,0,6,0,0,6,155,38,216,24,12,445
LGA10650,0,0,0,0,0,0,0,0,0,0,0,0,0,0,0,0,0,0,0,0,0,0,4,0,4,4,0,12,132,21,106,16,10,285
LGA10750,2044,214,240,4006,288,138,529,90,111,1156,106,56,260,48,54,524,38,20,98,17,15,188,160,21,152,21,49,403,4477,1208,6277,766,1190,13918
LGA10800,3,0,0,3,0,0,0,0,0,0,0,0,0,0,0,0,0,0,3,0,0,3,0,3,9,0,0,12,93,19,110,5,13,240
LGA10850,6,0,0,9,0,0,3,0,0,3,0,0,3,0,0,3,0,0,0,0,0,0,4,0,5,0,0,9,95,19,109,13,15,251
LGA10900,277,26,20,505,39,15,75,10,10,149,6,4,20,3,0,33,6,0,14,0,0,20,27,3,15,0,4,49,810,107,943,97,90,2047
LGA10950,0,0,0,0,0,0,0,0,0,0,0,0,0,0,0,0,0,0,0,0,0,0,5,0,7,0,0,12,50,6,61,3,7,127
LGA11000,0,0,0,0,0,0,0,0,0,0,0,0,0,0,0,0,0,3,0,0,0,3,3,0,3,0,0,6,33,3,44,0,4,84
LGA11050,0,0,0,0,0,0,0,0,0,0,0,0,0,0,0,0,0,0,0,0,0,0,0,0,0,3,0,3,31,3,43,3,3,83
LGA11100,295,32,44,648,103,19,122,17,33,294,148,21,118,11,30,328,38,17,93,8,13,169,34,3,24,3,8,72,999,142,957,110,191,2399
LGA11150,0,0,0,0,0,0,0,0,0,0,0,0,0,0,0,0,0,0,0,0,0,0,4,0,5,0,0,9,75,6,89,3,6,179
LGA11200,0,0,0,0,0,0,0,0,0,0,0,0,0,0,0,0,0,0,0,0,0,0,6,3,9,0,0,18,44,12,68,8,6,138
LGA11250,8,0,0,13,0,3,5,0,0,8,0,0,0,0,0,0,4,0,0,0,0,4,15,0,5,0,0,20,236,20,193,9,24,482
LGA11300,203,22,31,642,261,15,173,31,19,499,75,9,73,11,9,177,42,13,51,19,7,132,34,4,12,0,8,58,1040,70,638,106,93,1947
LGA11350,198,21,16,435,59,15,90,5,4,173,23,11,53,7,0,94,14,10,30,3,0,57,11,5,16,0,3,35,517,74,548,51,47,1237
LGA11400,3,0,0,8,0,0,3,0,0,3,3,0,0,0,0,3,0,0,0,0,0,0,12,3,11,0,0,26,166,31,179,15,23,414
LGA11450,283,33,57,609,65,49,215,29,43,401,18,14,34,13,11,90,13,3,10,4,4,34,19,7,8,3,4,41,547,162,765,109,165,1748
LGA11500,591,68,99,1203,59,34,99,20,37,249,5,4,19,3,8,39,7,3,16,0,4,30,73,22,56,16,25,192,2044,522,2492,303,673,6034
LGA11520,251,17,23,785,771,30,451,41,41,1334,534,42,379,34,35,1024,379,43,432,71,45,970,55,7,24,6,9,101,2584,154,1723,196,185,4842
LGA11550,953,125,148,2083,243,111,430,52,92,928,75,38,157,20,29,319,52,10,77,10,15,164,94,14,80,14,31,233,3377,599,4026,434,565,9001
LGA11600,3,0,0,3,0,0,0,0,0,0,0,0,0,0,0,0,0,0,0,0,0,0,4,3,7,0,0,14,60,13,55,3,3,134
LGA11700,0,0,0,0,0,0,0,0,0,0,0,0,0,0,0,0,0,0,0,0,0,0,3,0,3,3,0,9,63,9,66,3,3,144
LGA11720,147,7,10,263,9,3,12,0,0,24,3,0,3,0,0,6,8,0,3,0,0,11,14,4,21,0,6,45,701,99,809,53,117,1779
LGA11730,60,6,4,119,6,3,7,0,0,16,0,0,3,0,0,3,3,0,3,0,3,9,18,0,15,0,3,36,722,104,711,54,99,1690
LGA11750,6,0,0,6,0,0,0,0,0,0,0,0,0,0,0,0,0,0,3,0,0,3,5,0,8,0,0,13,125,16,143,12,15,311
LGA11800,370,49,34,727,42,19,89,5,15,170,3,3,23,3,3,35,11,0,8,5,0,24,35,0,30,4,5,74,1316,209,1310,126,167,3128
LGA11860,0,0,0,0,0,0,0,0,0,0,0,0,0,0,0,0,0,0,0,0,0,0,0,3,3,0,0,6,26,6,35,4,4,75
LGA12000,3,0,0,6,0,0,0,0,0,0,0,0,0,0,0,0,0,0,0,0,0,0,3,0,3,0,0,6,54,3,48,3,6,114
LGA12050,6,3,0,18,0,0,0,0,0,0,0,0,0,0,0,0,3,0,3,3,0,9,3,0,4,0,0,7,140,20,130,15,13,318
LGA12150,0,0,0,0,0,0,0,0,0,0,0,0,0,0,0,0,0,0,3,0,0,3,9,0,4,0,0,13,81,10,65,4,12,172
LGA12200,0,0,0,0,0,0,3,0,0,3,0,0,0,0,3,3,3,3,3,0,0,9,3,3,4,0,3,13,121,16,84,6,18,245
LGA12300,3,0,0,6,0,0,0,0,0,0,0,0,0,0,0,0,3,0,3,0,0,6,5,0,7,0,4,16,200,12,166,14,7,399
LGA12350,5,0,0,5,0,3,0,0,0,3,0,0,0,0,0,0,3,0,0,0,0,3,7,4,6,0,0,17,217,30,171,16,22,456
LGA12500,3,0,0,6,0,0,0,0,0,0,0,0,0,0,0,0,0,0,0,0,0,0,3,3,0,0,0,6,113,14,83,9,8,227
LGA12600,82,5,12,162,4,0,4,0,0,8,0,0,3,0,0,3,6,0,0,0,0,6,20,5,15,0,5,45,655,95,632,55,77,1514
LGA12700,7,0,0,13,4,0,0,0,0,4,0,0,0,0,0,0,0,0,0,0,0,0,3,0,3,0,0,6,102,10,98,9,25,244
LGA12750,67,11,8,152,7,3,3,0,0,13,0,0,0,0,0,0,6,0,0,0,4,10,19,3,14,3,4,43,675,84,556,51,99,1465
LGA12850,1198,233,301,2658,90,89,211,63,88,541,28,14,37,7,20,106,10,10,23,13,12,68,97,35,99,26,46,303,2638,913,3398,728,1048,8725
LGA12900,0,0,0,0,0,0,0,0,0,0,0,0,0,0,0,0,0,0,4,0,0,4,10,3,7,0,3,23,161,12,125,15,9,322
LGA12950,0,0,0,3,0,0,0,0,0,0,0,0,0,0,0,0,3,0,0,0,0,3,3,0,5,0,0,8,85,4,66,0,8,163
LGA13010,0,0,0,0,0,0,0,0,0,0,0,0,0,0,0,0,0,0,0,0,0,0,0,0,9,0,0,9,138,7,117,12,10,284
LGA13050,4,0,0,4,0,0,0,0,0,0,0,0,0,0,0,0,0,0,0,0,0,0,3,0,4,0,3,10,77,17,77,8,6,185
LGA13100,761,78,128,1612,151,58,236,26,47,518,31,25,70,20,16,162,40,15,49,10,5,119,65,3,53,11,6,138,2696,402,2504,260,391,6253
LGA13310,36,6,3,58,7,0,3,0,3,13,0,3,0,0,0,3,3,0,0,0,0,3,21,3,6,3,0,33,425,80,407,47,73,1032
LGA13320,71,14,14,157,5,0,9,0,0,14,3,0,3,0,0,6,5,0,0,0,0,5,20,3,14,5,3,45,649,87,522,66,79,1403
LGA13340,3,0,3,6,0,0,0,0,0,0,0,0,0,0,0,0,0,0,3,0,0,3,7,0,8,3,4,22,122,15,146,13,11,307
LGA13380,50,7,4,105,0,0,4,3,3,10,0,0,0,0,0,0,11,0,0,5,0,16,23,4,18,3,3,51,778,120,677,77,111,1763
LGA13450,40,5,3,75,0,0,4,0,0,4,0,0,0,0,3,3,0,0,3,0,0,3,14,3,17,3,3,40,451,76,530,48,77,1182
LGA13500,0,0,0,3,0,0,0,0,0,0,0,0,0,0,0,0,3,0,0,0,0,3,5,0,3,0,0,8,71,6,63,0,9,149
LGA13550,24,0,0,41,3,0,5,0,0,8,0,0,0,0,0,0,3,0,0,0,0,3,13,0,16,3,4,36,201,32,246,21,36,536
LGA13650,0,0,0,0,0,0,3,0,0,3,0,0,0,0,0,0,0,0,0,0,0,0,10,0,3,0,0,13,68,14,69,0,12,163
LGA13660,0,0,0,0,0,0,0,0,0,0,0,0,0,0,0,0,0,0,0,3,0,3,8,0,10,0,0,18,111,25,100,9,7,252
LGA13700,3,0,0,3,0,0,0,0,0,0,0,0,0,0,0,0,0,0,0,0,0,0,3,0,10,0,0,13,55,16,55,3,3,132
LGA13800,229,20,40,528,35,12,62,8,8,125,19,6,26,3,12,66,17,3,9,3,3,35,23,7,42,3,3,78,877,157,944,96,162,2236
LGA13850,0,0,0,3,0,0,0,0,0,0,0,0,0,0,0,0,0,0,0,0,0,0,6,0,4,0,0,10,64,7,62,4,4,141
LGA13950,1220,136,136,2505,148,59,263,42,28,540,34,5,59,11,16,125,17,6,20,0,5,48,60,17,52,8,19,156,2238,358,2760,310,350,6016
LGA14000,811,97,76,1849,493,126,809,123,90,1641,143,87,367,97,60,754,89,84,303,81,37,594,57,9,54,9,18,147,2181,429,2708,479,334,6131
LGA14100,29,3,3,71,35,0,34,0,4,73,31,0,36,4,6,77,37,18,75,15,17,162,3,0,5,0,0,8,222,18,200,25,42,507
LGA14150,539,72,76,1380,273,58,319,56,73,779,89,20,107,24,17,257,44,17,59,19,13,152,51,6,49,18,9,133,1782,229,1493,244,264,4012
LGA14200,17,0,0,24,0,0,3,0,0,3,0,0,0,0,0,0,4,0,0,0,4,8,8,3,8,4,4,27,258,47,282,27,41,655
LGA14250,0,0,0,3,0,0,0,0,0,0,0,0,0,0,0,0,0,0,0,0,0,0,6,0,3,0,0,9,21,3,31,3,0,58
LGA14300,3,0,0,3,0,0,3,0,0,3,0,0,0,0,0,0,0,0,0,0,0,0,4,0,3,0,3,10,63,9,86,7,9,174
LGA14350,20,0,0,41,0,0,3,0,0,3,3,0,0,0,0,3,0,0,0,0,4,4,12,0,11,3,3,29,389,67,374,36,66,932
LGA14400,119,13,9,245,18,6,29,6,10,69,4,0,14,0,0,18,4,3,6,0,0,13,10,0,4,0,0,14,313,45,301,43,30,732
LGA14450,384,57,59,1053,263,42,234,38,27,604,84,23,87,17,23,234,49,14,57,10,14,144,49,4,27,3,6,89,1345,136,1047,159,171,2858
LGA14500,103,10,9,303,232,20,187,44,22,505,169,34,260,47,27,537,221,231,996,215,84,1747,25,10,37,4,3,79,982,326,1679,342,172,3501
LGA14550,0,0,0,0,0,0,0,0,0,0,0,0,0,0,0,0,0,0,0,0,0,0,8,0,10,0,0,18,115,23,122,10,16,286
LGA14600,3,0,0,3,0,0,0,0,0,0,0,0,0,0,0,0,3,0,0,0,0,3,8,0,5,0,0,13,110,10,137,9,16,282
LGA14650,572,68,90,1290,102,44,196,31,37,410,20,7,35,11,3,76,24,5,26,5,6,66,56,15,34,5,15,125,2722,409,2494,273,497,6395
LGA14700,198,10,13,571,199,10,104,13,11,337,83,5,106,11,3,208,97,27,241,27,15,407,21,3,14,0,0,38,881,62,715,73,57,1788
LGA14750,0,0,0,0,0,0,0,0,0,0,0,0,0,0,0,0,4,0,0,0,0,4,4,3,7,4,0,18,163,26,157,4,21,371
LGA14800,101,3,3,434,500,4,178,12,6,700,510,3,237,11,13,774,564,24,531,28,36,1183,48,3,23,7,0,81,2245,46,1176,76,82,3625
LGA14850,103,8,10,185,6,3,11,0,3,23,0,0,0,0,0,0,3,0,0,0,0,3,19,0,9,3,0,31,594,89,657,50,86,1476
LGA14870,19,0,3,27,0,0,0,0,3,3,0,0,0,0,0,0,4,0,4,0,0,8,5,0,8,3,0,16,254,43,255,18,48,618
LGA14900,1139,195,246,2417,245,135,420,105,100,1005,32,28,86,17,29,192,19,11,34,8,10,82,74,23,106,32,31,266,2455,823,3642,619,805,8344
LGA14920,0,0,0,0,0,0,3,0,0,3,0,0,0,0,0,0,0,0,4,0,0,4,11,3,9,4,0,27,170,27,156,17,13,383
LGA14950,0,0,0,0,0,0,0,0,0,0,0,0,0,0,0,0,0,0,0,3,0,3,0,0,0,0,0,0,27,3,33,12,3,78
LGA15050,379,29,35,669,31,12,71,3,11,128,0,0,7,3,4,14,4,0,6,0,0,10,27,3,23,3,6,62,1047,173,1264,112,187,2783
LGA15150,115,4,3,415,401,8,111,9,6,535,309,6,113,4,8,440,461,62,530,44,18,1115,25,0,24,0,0,49,1654,89,959,73,47,2822
LGA15200,353,37,32,1413,656,17,254,24,18,969,383,6,181,13,8,591,231,14,161,18,6,430,54,3,19,5,3,84,3206,107,1343,132,139,4927
LGA15270,71,12,3,129,11,3,14,0,0,28,0,3,3,0,0,6,3,0,7,0,0,10,23,4,19,0,3,49,389,71,423,38,47,968
LGA15300,13,0,0,19,0,0,6,0,0,6,0,0,0,0,0,0,0,3,0,3,0,6,14,3,20,0,0,37,301,65,363,29,46,804
LGA15350,58,3,3,351,223,0,98,4,8,333,117,4,63,3,3,190,190,49,454,40,21,754,12,7,17,0,3,39,908,67,720,53,44,1792
LGA15500,8,3,0,20,3,0,0,0,0,3,0,0,0,0,0,0,3,0,0,0,0,3,6,0,0,0,0,6,141,12,100,6,12,271
LGA15550,0,0,0,0,0,0,0,0,0,0,0,0,0,0,0,0,0,0,0,0,0,0,3,3,7,0,0,13,59,12,37,0,7,115
LGA15650,122,4,5,207,7,3,14,3,0,27,0,0,3,0,0,3,4,0,0,0,0,4,6,5,15,4,0,30,326,50,406,28,45,855
LGA15700,13,3,0,30,0,3,0,0,0,3,0,0,0,0,0,0,3,0,0,0,0,3,0,0,10,4,0,14,308,44,250,21,30,653
LGA15750,24,0,0,40,3,0,4,0,0,7,0,0,0,0,0,0,4,0,0,0,0,4,16,0,13,0,0,29,254,34,263,23,28,602
LGA15800,3,0,0,3,0,0,0,0,0,0,0,0,0,0,0,0,0,0,0,0,0,0,4,0,5,3,0,12,82,18,54,3,10,167
LGA15850,3,0,0,3,0,0,0,0,0,0,0,0,0,0,0,0,0,0,3,0,0,3,7,0,6,0,0,13,105,13,101,6,12,237
LGA15900,603,42,46,1454,192,22,169,13,24,420,75,13,67,7,7,169,50,8,65,13,5,141,106,9,42,4,14,175,3439,251,2244,186,255,6375
LGA15950,188,16,11,1260,1226,6,300,21,29,1582,787,6,231,15,21,1060,914,45,685,96,52,1792,75,3,46,5,3,132,4478,70,1534,158,130,6370
LGA16100,3,0,0,3,0,0,0,0,0,0,0,0,0,0,0,0,0,0,0,0,0,0,4,3,3,0,0,10,76,11,92,6,9,194
LGA16150,170,12,12,319,14,8,53,7,5,87,3,3,9,0,0,15,7,0,10,0,0,17,21,0,22,0,0,43,674,110,804,65,97,1750
LGA16180,34,0,0,62,11,5,19,0,0,35,3,4,21,7,0,35,0,0,11,0,4,15,8,0,3,0,0,11,160,20,176,13,7,376
LGA16200,12,3,0,22,3,3,0,3,0,9,0,0,0,0,0,0,0,0,4,0,0,4,8,0,5,3,0,16,223,30,251,24,26,554
LGA16250,2162,190,177,4815,540,93,619,86,98,1436,140,22,148,31,23,364,64,18,87,22,14,205,138,17,118,14,24,311,5176,559,4876,559,570,11740
LGA16350,869,93,127,1813,81,38,182,27,49,377,29,22,35,7,18,111,16,18,28,6,3,71,74,18,80,16,23,211,2493,527,2954,302,528,6804
LGA16370,99,8,10,282,143,10,148,20,12,333,91,16,143,30,26,306,162,79,440,68,54,803,24,3,24,5,7,63,731,128,950,134,119,2062
LGA16380,370,33,32,697,38,21,64,9,5,137,6,3,10,0,4,23,9,0,13,4,0,26,44,3,23,5,9,84,1317,204,1270,131,160,3082
LGA16400,267,30,25,534,35,14,70,0,5,124,6,0,18,4,3,31,11,3,22,0,0,36,41,4,38,3,4,90,1204,207,1375,112,183,3081
LGA16470,206,10,27,479,64,19,104,15,19,221,24,5,45,3,8,85,15,7,30,4,3,59,19,3,27,3,7,59,832,95,849,67,101,1944
LGA16550,480,53,62,1878,1466,48,620,72,69,2275,675,25,397,48,39,1184,597,96,853,111,71,1728,126,7,57,11,4,205,4993,249,2798,356,313,8709
LGA16610,15,0,3,36,0,0,3,0,0,3,0,0,0,0,0,0,3,3,3,0,0,9,20,3,5,0,4,32,371,60,375,30,43,879
LGA16650,831,73,99,2123,505,74,441,47,75,1142,139,26,164,21,39,389,94,21,108,22,19,264,64,13,51,12,8,148,2656,294,2136,248,325,5659
LGA16700,714,72,62,2013,502,50,533,69,54,1208,202,28,282,44,35,591,134,34,225,35,25,453,68,3,48,3,16,138,3211,206,2294,289,260,6260
LGA16900,292,30,47,563,24,28,79,14,12,157,0,3,19,0,0,22,9,0,9,0,0,18,27,3,16,0,7,53,921,205,986,111,214,2437
LGA16950,151,18,12,319,14,5,12,3,0,34,3,0,8,3,0,14,10,0,12,0,0,22,33,5,32,4,7,81,1464,256,1414,139,191,3464
LGA17000,155,5,10,275,16,9,31,8,0,64,4,0,3,0,0,7,8,0,3,0,0,11,11,3,19,3,7,43,393,56,477,36,63,1025
LGA17050,17,3,0,35,0,0,3,0,0,3,3,3,0,0,0,6,4,0,4,0,0,8,6,0,9,0,0,15,118,10,132,9,9,278
LGA17100,346,46,42,902,259,30,187,50,34,560,63,14,54,22,18,171,29,16,46,21,9,121,36,5,19,6,3,69,1069,134,818,189,135,2345
LGA17150,779,64,93,2172,513,80,649,93,77,1412,205,55,368,58,69,755,140,80,337,65,74,696,78,8,47,11,5,149,3142,354,2713,367,400,6976
LGA17200,222,14,26,2319,2751,17,407,22,26,3223,2264,11,370,18,28,2691,2803,29,684,102,84,3702,234,3,42,12,22,313,11933,107,2066,242,271,14619
LGA17310,130,11,14,240,10,0,14,0,0,24,0,3,0,0,0,3,5,0,3,3,3,14,37,11,19,4,9,80,994,121,1001,81,148,2345
LGA17350,0,0,0,0,0,0,0,0,0,0,0,0,0,0,0,0,0,0,0,0,0,0,0,0,0,0,0,0,78,13,68,8,3,170
LGA17400,0,0,0,0,0,0,0,0,0,0,0,0,0,0,0,0,0,0,0,0,0,0,0,0,5,0,0,5,97,6,98,14,7,222
LGA17420,508,71,52,1103,413,113,709,109,89,1433,174,85,413,75,83,830,129,114,332,86,59,720,43,14,54,17,22,150,1603,428,2355,407,360,5153
LGA17450,0,0,0,0,0,0,0,0,0,0,0,0,0,0,0,0,0,0,0,0,0,0,3,0,5,0,0,8,63,12,56,9,0,140
LGA17500,4,3,0,7,0,0,0,0,0,0,0,0,0,0,0,0,3,0,4,0,0,7,7,0,0,0,0,7,190,36,200,21,19,466
LGA17550,558,59,70,1199,93,40,161,24,14,332,22,15,48,5,5,95,20,10,33,4,4,71,45,6,25,3,3,82,1612,238,1477,173,200,3700
LGA17620,37,3,0,54,0,0,3,0,0,3,0,0,0,0,0,0,4,0,0,0,0,4,22,5,19,5,0,51,291,37,324,19,34,705
LGA17640,0,0,0,0,3,0,3,0,0,6,0,0,0,0,0,0,0,0,0,0,0,0,3,3,6,0,0,12,100,12,84,12,14,222
LGA17650,3,0,0,12,0,0,0,0,0,0,0,0,0,0,0,0,0,0,3,0,0,3,3,0,3,0,0,6,91,14,81,8,11,205
LGA17700,0,0,0,0,0,0,0,0,0,0,0,0,0,0,0,0,0,0,0,0,0,0,0,0,0,0,0,0,12,3,12,0,0,27
LGA17750,169,14,14,334,29,13,35,0,0,77,7,4,4,0,0,15,5,3,5,0,0,13,33,8,35,5,0,81,1226,131,1152,77,100,2686
LGA17800,3,0,0,3,0,0,0,0,0,0,0,0,0,0,0,0,0,0,0,0,0,0,4,0,7,0,0,11,97,6,57,3,10,173
LGA17850,0,0,0,0,0,0,0,0,0,0,0,0,0,0,0,0,4,0,0,0,0,4,3,4,3,0,0,10,68,13,63,6,6,156
LGA17900,0,0,0,3,0,0,0,0,0,0,0,0,0,0,0,0,0,0,4,0,0,4,10,0,18,0,0,28,136,17,168,11,21,353
LGA17950,0,0,0,0,0,0,0,0,0,0,0,0,0,0,0,0,3,0,0,0,0,3,5,0,7,0,3,15,50,8,74,0,12,144
LGA18000,461,44,38,1593,803,40,513,46,61,1463,351,45,414,52,47,909,373,152,935,115,90,1665,67,10,54,6,8,145,3155,309,2662,303,276,6705
LGA18020,0,0,0,0,0,3,0,0,0,3,0,0,0,0,0,0,0,0,0,0,0,0,15,0,8,0,0,23,149,34,170,17,18,388
LGA18050,169,16,11,767,794,9,240,15,26,1084,584,12,193,15,12,816,777,56,631,45,40,1549,75,4,38,4,8,129,3125,90,1373,118,118,4824
LGA18100,0,0,0,0,0,0,0,0,0,0,0,0,0,0,0,0,0,0,0,0,0,0,3,0,3,0,0,6,51,11,52,3,6,123
LGA18150,0,0,0,4,3,0,3,0,0,6,0,0,0,0,0,0,0,0,0,0,0,0,3,0,8,0,4,15,125,24,147,11,16,323
LGA18200,3,3,0,6,0,0,4,0,0,4,0,0,0,0,0,0,0,0,0,0,0,0,0,0,3,0,0,3,124,15,122,9,12,282
LGA18250,189,29,24,703,731,27,446,52,28,1284,329,19,286,21,29,684,348,87,790,93,46,1364,46,7,45,7,3,108,2146,160,1876,226,151,4559
LGA18350,159,11,24,336,46,18,57,3,10,134,9,5,29,4,7,54,11,3,22,3,4,43,27,0,17,0,5,49,625,119,654,46,105,1549
LGA18400,103,9,27,215,19,14,44,8,13,98,7,6,14,4,8,39,6,0,13,4,3,26,22,7,19,5,0,53,365,84,496,56,89,1090
LGA18450,666,74,66,1480,177,55,245,23,30,530,52,8,84,10,16,170,40,13,40,5,10,108,108,8,58,14,16,204,3569,391,2739,336,481,7516
LGA18500,66,3,11,382,405,3,113,11,7,539,391,6,137,8,3,545,660,82,704,73,55,1574,53,9,26,5,4,97,2005,110,1128,109,87,3439
LGA18550,576,71,114,1221,52,33,102,5,20,212,16,9,34,3,4,66,19,3,18,0,4,44,70,9,47,7,8,141,2436,450,2524,237,466,6113
LGA18710,41,3,6,83,15,0,19,4,4,42,0,4,10,3,0,17,5,0,0,0,0,5,6,0,10,0,0,16,186,24,235,22,29,496
LGA18750,3,0,0,7,0,0,0,3,0,3,0,0,0,0,0,0,0,0,3,0,0,3,5,0,3,0,3,11,195,22,190,17,19,443
LGA19399,0,0,0,0,0,0,0,0,0,0,0,0,3,0,0,3,0,0,0,0,0,0,0,0,4,0,0,4,20,3,38,0,0,61
LGA20110,4,0,0,7,3,0,0,0,0,3,0,0,0,0,0,0,3,0,0,0,0,3,4,0,5,3,0,12,194,29,147,18,12,400
LGA20260,6,0,0,10,3,0,0,0,0,3,0,0,0,0,0,0,0,0,0,0,0,0,4,0,4,3,0,11,124,20,157,18,11,330
LGA20570,122,15,13,242,3,3,15,3,0,24,6,3,0,0,0,9,4,0,7,0,4,15,46,0,33,4,8,91,1543,190,1336,145,148,3362
LGA20660,475,52,48,1109,119,17,166,24,17,343,17,9,41,12,5,84,28,8,41,6,11,94,63,6,46,9,9,133,2017,216,1642,181,200,4256
LGA20740,94,5,8,162,27,0,41,0,3,71,5,3,8,0,0,16,10,4,8,0,0,22,19,0,18,3,5,45,518,43,524,43,60,1188
LGA20830,21,3,3,49,0,0,6,0,0,6,0,0,0,0,0,0,6,0,0,0,0,6,18,4,28,3,6,59,543,65,525,50,67,1250
LGA20910,261,21,25,742,240,23,252,34,18,567,115,35,190,32,15,387,179,112,653,97,35,1076,44,0,33,3,6,86,1457,218,1612,220,133,3640
LGA21010,3,3,0,6,0,0,0,0,0,0,0,0,0,0,0,0,3,0,0,0,0,3,8,0,3,3,0,14,202,27,180,20,19,448
LGA21110,531,74,37,2032,464,44,426,76,38,1048,175,44,305,59,23,606,214,121,677,156,55,1223,83,20,61,14,6,184,3840,316,2509,464,215,7344
LGA21180,270,57,50,618,21,14,31,10,5,81,8,3,10,0,0,21,34,8,44,5,5,96,110,19,109,22,21,281,2464,463,2928,339,415,6609
LGA21270,0,0,0,0,0,0,0,0,0,0,0,0,0,0,0,0,0,0,0,0,0,0,6,3,8,0,0,17,65,12,76,9,8,170
LGA21370,11,3,4,32,0,0,4,0,0,4,0,0,5,0,0,5,0,0,5,0,0,5,21,4,16,0,6,47,545,65,497,41,77,1225
LGA21450,216,26,27,388,13,5,22,0,4,44,5,0,6,0,0,11,9,0,7,0,3,19,44,3,28,3,5,83,859,138,1184,95,137,2413
LGA21610,830,100,124,1695,54,29,114,21,22,240,11,4,29,0,3,47,41,12,44,3,9,109,90,23,114,22,35,284,2745,676,3753,389,516,8079
LGA21670,3,0,0,6,0,0,0,0,0,0,0,0,0,0,0,0,4,0,0,0,0,4,9,0,7,0,0,16,175,17,113,6,15,326
LGA21750,7,0,0,16,0,0,0,0,0,0,0,4,0,0,0,4,3,3,0,0,0,6,30,0,11,4,0,45,273,33,263,17,26,612
LGA21830,3,0,0,7,0,0,0,0,0,0,0,0,0,0,0,0,0,0,4,0,0,4,15,0,24,3,3,45,237,40,264,23,24,588
LGA21890,552,40,39,1626,306,14,177,15,15,527,73,8,90,3,3,177,96,12,76,3,4,191,91,12,64,7,17,191,4137,228,2360,215,250,7190
LGA22110,35,0,4,58,3,0,0,3,3,9,3,0,0,0,0,3,11,0,3,0,0,14,30,4,15,3,3,55,668,100,565,60,72,1465
LGA22170,339,50,58,733,53,11,70,20,16,170,11,0,18,6,3,38,15,7,25,3,3,53,62,5,40,5,11,123,2027,269,1972,201,317,4786
LGA22250,0,0,0,0,0,0,3,0,0,3,0,0,0,0,0,0,3,0,0,0,0,3,10,0,10,0,4,24,157,24,125,14,20,340
LGA22310,716,79,58,2017,354,56,475,49,43,977,131,38,238,24,15,446,108,56,314,55,19,552,90,7,63,8,8,176,3806,259,2574,308,219,7166
LGA22410,5,0,0,12,0,3,0,0,0,3,0,0,0,0,0,0,0,0,3,3,0,6,9,0,12,0,3,24,262,38,247,20,29,596
LGA22490,13,3,0,24,3,0,3,0,0,6,0,0,0,0,0,0,0,0,0,0,0,0,6,0,6,0,0,12,119,21,115,7,18,280
LGA22620,123,16,15,250,6,3,22,3,0,34,0,0,7,0,0,7,10,0,8,0,0,18,45,6,29,5,5,90,1489,211,1383,133,170,3386
LGA22670,278,50,29,661,30,9,35,3,6,83,13,5,7,3,0,28,54,8,45,3,4,114,106,23,100,23,35,287,3094,481,3393,398,407,7773
LGA22750,496,74,66,1042,72,22,110,11,21,236,5,5,24,5,4,43,30,11,21,0,0,62,86,13,64,16,24,203,3352,433,2853,324,435,7397
LGA22830,57,9,6,118,6,0,10,3,0,19,0,0,3,0,0,3,3,3,3,3,3,15,42,7,35,3,7,94,928,176,963,84,124,2275
LGA22910,6,0,0,9,3,0,3,0,0,6,0,0,3,0,0,3,3,0,0,0,0,3,6,0,3,0,0,9,168,19,140,12,4,343
LGA22980,0,0,0,0,4,0,0,0,0,4,0,0,0,0,0,0,0,0,0,0,0,0,3,0,3,0,0,6,76,3,59,3,0,141
LGA23110,271,19,21,690,145,14,122,16,15,312,34,9,54,8,6,111,50,4,54,8,5,121,44,10,49,4,5,112,1921,158,1453,139,159,3830
LGA23190,10,0,3,28,3,0,4,0,0,7,0,0,0,0,0,0,3,0,0,0,0,3,9,0,12,0,0,21,302,34,244,12,34,626
LGA23270,418,55,61,834,19,21,35,9,15,99,5,0,18,0,5,28,28,5,24,0,5,62,49,20,70,17,22,178,1642,508,2459,286,405,5300
LGA23350,6,0,3,17,3,0,0,0,0,3,3,0,0,0,0,3,3,0,3,0,0,6,8,0,6,0,0,14,174,26,162,14,18,394
LGA23430,596,48,76,1403,187,49,278,38,32,584,49,16,117,13,15,210,44,7,85,14,3,153,73,9,37,10,19,148,2623,247,2098,226,288,5482
LGA23670,553,87,86,1222,42,25,107,29,22,225,11,13,25,3,6,58,12,3,25,4,0,44,56,11,39,9,5,120,1621,244,1583,235,268,3951
LGA23810,52,6,3,95,3,3,3,3,0,12,3,0,4,0,0,7,9,0,5,0,0,14,25,6,29,4,6,70,997,119,897,69,115,2197
LGA23940,0,0,0,0,0,0,0,0,0,0,0,0,0,0,0,0,0,0,0,0,0,0,7,0,8,0,0,15,100,15,74,11,3,203
LGA24130,86,16,6,167,12,6,30,6,3,57,0,0,8,0,0,8,7,3,6,0,3,19,4,3,13,3,3,26,363,62,425,51,54,955
LGA24210,500,104,91,1212,148,62,265,72,45,592,43,27,97,22,20,209,33,21,60,20,18,152,39,8,39,8,14,108,1233,256,1322,278,270,3359
LGA24250,0,0,0,5,3,0,0,0,0,3,0,0,0,0,0,0,3,0,0,0,0,3,8,3,8,0,0,19,95,14,107,6,12,234
LGA24330,295,23,9,998,176,3,104,8,10,301,29,3,29,3,3,67,36,3,27,3,3,72,43,8,30,10,6,97,2462,141,1449,138,136,4326
LGA24410,354,38,57,848,36,29,62,16,13,156,8,4,23,3,3,41,23,3,17,0,3,46,40,3,18,10,8,79,1618,211,1319,158,182,3488
LGA24600,324,16,6,2412,1302,11,259,23,11,1606,540,7,123,13,15,698,542,31,196,61,49,879,105,4,26,13,4,152,5990,121,1290,160,146,7707
LGA24650,293,38,34,543,13,8,20,9,3,53,3,3,10,3,0,19,10,3,8,3,3,27,43,7,39,3,6,98,1164,195,1475,136,201,3171
LGA24780,32,5,4,63,0,0,3,0,0,3,0,0,0,0,0,0,4,4,3,0,0,11,30,6,9,3,6,54,877,148,831,88,98,2042
LGA24850,54,10,10,105,0,3,9,0,0,12,3,0,3,0,0,6,0,0,4,0,0,4,13,0,18,0,7,38,411,61,527,43,69,1111
LGA24900,14,3,0,24,3,0,3,0,0,6,3,0,0,0,0,3,4,0,0,0,0,4,20,7,15,3,3,48,471,52,398,33,43,997
LGA24970,1163,188,126,2715,288,109,423,83,40,943,69,22,129,29,9,258,71,17,84,22,12,206,108,15,76,11,11,221,3301,474,3014,471,366,7626
LGA25060,404,39,35,1324,152,13,186,21,19,391,56,15,80,9,13,173,35,15,53,8,6,117,58,7,44,3,9,121,2611,163,1572,162,172,4680
LGA25150,18,6,0,49,0,0,6,0,0,6,0,0,0,0,0,0,0,0,6,0,0,6,18,0,8,0,0,26,280,43,275,27,25,650
LGA25250,658,50,57,2213,396,17,175,23,15,626,76,7,46,8,5,142,74,4,50,4,6,138,87,11,61,4,9,172,4509,226,2569,219,267,7790
LGA25340,414,43,57,821,56,20,131,24,18,249,24,5,42,15,6,92,36,19,54,9,10,128,83,12,52,3,9,159,1880,236,1931,178,274,4499
LGA25430,9,0,3,23,0,0,3,0,0,3,0,0,0,0,0,0,0,0,3,0,0,3,3,0,5,3,0,11,171,18,178,6,17,390
LGA25490,10,0,0,19,0,0,0,3,0,3,4,0,0,0,0,4,0,0,7,0,0,7,17,3,13,0,0,33,219,32,260,29,17,557
LGA25620,5,0,0,11,3,0,3,0,0,6,0,0,0,0,0,0,0,0,0,0,0,0,12,0,7,0,0,19,151,12,121,10,20,314
LGA25710,143,13,14,260,24,19,56,16,11,126,5,3,17,4,5,34,6,4,13,6,4,33,12,4,5,3,5,29,309,65,355,56,61,846
LGA25810,5,0,0,8,0,0,0,0,0,0,0,0,0,0,0,0,4,0,0,0,0,4,0,0,6,0,0,6,176,18,138,0,17,349
LGA25900,289,14,19,2280,1061,9,239,17,10,1336,548,0,195,10,9,762,577,28,455,37,34,1131,111,3,29,7,7,157,6119,68,1567,111,114,7979
LGA25990,0,0,0,3,0,0,0,0,0,0,0,0,0,0,0,0,0,0,0,0,0,0,3,0,3,0,4,10,60,6,60,0,12,138
LGA26080,4,3,0,19,0,0,3,0,0,3,0,0,4,0,0,4,3,0,3,0,0,6,0,0,0,0,0,0,58,9,52,7,3,129
LGA26170,10,0,0,16,0,0,0,0,0,0,0,0,0,0,0,0,3,0,8,0,0,11,21,4,27,4,0,56,335,54,346,29,28,792
LGA26260,12,0,0,17,4,0,0,0,0,4,0,0,0,0,0,0,0,0,3,0,0,3,9,5,8,3,0,25,243,30,216,18,30,537
LGA26350,270,24,24,1731,632,13,185,13,18,861,333,12,129,19,16,509,295,57,414,66,26,858,87,3,40,8,5,143,4384,111,1373,160,132,6160
LGA26430,4,0,0,4,0,0,0,0,0,0,0,0,0,0,0,0,0,0,0,0,0,0,13,0,10,0,0,23,139,15,111,9,17,291
LGA26490,152,13,11,262,21,11,69,3,3,107,4,4,21,0,0,29,0,0,6,3,3,12,9,0,13,0,0,22,381,50,453,34,31,949
LGA26610,5,0,0,13,0,3,0,0,0,3,0,0,0,0,0,0,0,0,4,0,0,4,13,3,18,0,0,34,381,64,354,25,36,860
LGA26670,3,0,0,3,0,0,3,0,0,3,0,0,0,0,0,0,0,0,0,0,0,0,4,0,4,0,0,8,92,7,78,7,3,187
LGA26700,7,4,0,20,0,3,0,0,0,3,3,0,0,0,0,3,3,0,3,0,0,6,17,4,13,3,0,37,360,49,311,40,41,801
LGA26730,100,14,8,193,7,8,15,3,0,33,0,0,0,0,0,0,5,4,9,0,0,18,22,0,6,0,3,31,555,75,560,44,57,1291
LGA26810,28,0,3,50,3,0,8,0,0,11,4,0,0,0,0,4,12,0,0,0,0,12,26,8,12,0,7,53,612,90,581,42,65,1390
LGA26890,0,0,0,0,0,0,0,0,0,0,0,0,0,0,0,0,0,0,3,0,0,3,10,0,7,0,0,17,64,17,54,6,3,144
LGA26980,793,112,81,1977,219,47,290,47,34,637,41,21,79,20,14,175,44,15,74,14,6,153,97,4,45,12,9,167,3030,290,2169,331,275,6095
LGA27070,628,71,86,1248,30,15,70,6,14,135,0,3,10,3,5,21,20,4,41,4,4,73,72,14,78,9,17,190,1786,373,2404,276,376,5215
LGA27170,78,12,4,147,6,5,13,3,0,27,3,0,4,0,0,7,3,0,4,3,0,10,15,0,23,5,7,50,720,110,825,86,76,1817
LGA27260,590,43,50,1072,38,14,99,11,9,171,15,4,33,6,3,61,23,0,42,5,6,76,86,18,59,8,10,181,2547,445,3452,269,326,7039
LGA27350,162,7,12,1318,983,3,183,9,10,1188,409,5,116,12,3,545,267,7,140,22,16,452,71,4,36,8,8,127,4084,82,1074,122,148,5510
LGA27450,300,45,31,601,21,18,41,9,8,97,8,10,9,4,3,34,4,0,9,3,3,19,33,5,32,10,10,90,1132,217,1270,163,149,2931
LGA27630,0,0,0,0,0,0,0,0,0,0,3,0,0,0,0,3,0,0,0,0,0,0,0,3,8,0,0,11,85,10,68,4,4,171
LGA29399,0,0,0,0,0,0,0,0,0,0,0,0,0,0,0,0,0,0,0,0,0,0,3,0,3,0,0,6,9,0,3,0,0,12
LGA30250,0,0,0,0,0,0,0,0,0,0,0,0,0,0,0,0,0,0,0,0,0,0,3,3,3,0,3,12,42,9,102,3,16,172
LGA30300,0,3,0,3,0,0,0,0,0,0,0,0,0,0,0,0,3,0,0,0,0,3,5,0,13,0,0,18,111,15,141,16,17,300
LGA30370,56,3,0,91,16,0,23,0,0,39,3,0,3,0,0,6,3,0,4,0,0,7,27,0,15,3,5,50,377,47,434,29,29,916
LGA30410,0,0,0,0,0,0,0,0,0,0,0,0,0,0,0,0,3,0,0,0,0,3,11,3,11,0,3,28,75,12,94,4,8,193
LGA30450,0,0,0,0,0,0,0,0,0,0,0,0,0,0,0,0,0,0,0,0,0,0,3,0,0,3,0,6,14,6,7,3,0,30
LGA30760,0,0,0,0,0,0,0,0,0,0,0,0,0,0,0,0,3,0,0,0,0,3,3,0,6,0,0,9,69,6,46,4,6,131
LGA30900,0,0,0,0,0,0,0,0,0,0,0,0,0,0,0,0,0,0,0,0,0,0,3,0,3,0,0,6,21,0,20,0,0,41
LGA31000,7832,795,874,22380,3702,418,2540,364,330,7354,1296,177,1125,180,125,2903,1012,277,1429,263,126,3107,577,52,360,65,71,1125,30480,2746,19528,2245,2387,57386
LGA31750,0,0,0,0,0,0,0,0,0,0,0,0,0,0,0,0,0,0,0,0,0,0,3,0,0,0,0,3,14,0,21,0,3,38
LGA31820,97,14,9,210,16,0,15,3,0,34,0,3,0,0,0,3,5,5,3,0,3,16,49,4,36,4,3,96,1698,233,1623,141,213,3908
LGA31900,11,4,3,21,3,0,7,0,0,10,0,0,0,0,0,0,3,0,0,0,0,3,16,0,13,0,4,33,331,51,323,33,47,785
LGA31950,0,0,0,3,0,0,0,0,0,0,0,0,0,0,0,0,0,0,0,0,0,0,0,0,0,0,0,0,21,3,13,0,3,40
LGA32070,814,85,81,1893,138,37,173,15,17,380,40,10,47,6,10,113,42,9,28,3,3,85,82,10,64,10,4,170,4276,550,3593,303,392,9114
LGA32250,4,0,0,8,0,0,0,0,0,0,0,0,0,0,0,0,6,0,0,0,0,6,6,0,3,0,3,12,86,3,86,0,9,184
LGA32260,56,6,7,113,4,0,12,0,0,16,3,0,0,0,0,3,3,0,0,0,0,3,28,9,14,0,6,57,582,74,569,45,93,1363
LGA32270,108,8,18,247,88,8,125,10,11,242,40,12,71,3,3,129,39,4,62,8,7,120,56,5,99,10,12,182,938,153,1247,89,112,2539
LGA32310,10,0,3,16,0,0,3,0,3,6,0,0,0,0,0,0,0,0,0,0,0,0,4,3,14,3,3,27,214,33,254,13,25,539
LGA32330,0,0,0,0,0,0,0,0,0,0,0,0,0,0,0,0,0,0,0,0,0,0,0,0,3,0,0,3,42,4,89,0,8,143
LGA32450,4,0,3,19,4,0,0,0,0,4,0,0,0,0,0,0,0,0,0,0,0,0,10,0,16,0,0,26,123,15,108,4,11,261
LGA32500,10,0,0,18,3,0,3,0,0,6,0,0,0,0,0,0,3,0,0,0,0,3,3,0,8,0,0,11,108,7,115,3,15,248
LGA32600,0,0,0,0,0,0,0,0,0,0,0,0,0,0,0,0,0,0,0,0,0,0,0,0,0,3,0,3,8,0,13,3,0,24
LGA32750,0,0,0,0,0,0,0,0,0,0,0,0,0,0,0,0,0,0,0,0,0,0,0,0,6,0,0,6,11,0,19,0,6,36
LGA32770,5,0,0,5,0,0,0,0,0,0,0,0,0,0,0,0,0,0,3,0,0,3,0,0,3,0,0,3,33,6,112,0,11,162
LGA33100,0,0,0,0,0,0,0,0,0,0,0,0,0,0,0,0,0,0,0,0,0,0,4,0,3,0,0,7,22,0,25,0,0,47
LGA33200,0,0,0,0,0,0,0,0,0,0,0,0,0,0,0,0,0,0,0,0,0,0,6,0,3,0,0,9,52,3,48,3,3,109
LGA33220,104,12,10,232,7,0,19,4,3,33,3,0,5,0,3,11,11,0,4,3,0,18,55,5,39,0,10,109,1901,304,1872,152,226,4455
LGA33360,491,30,54,945,92,37,236,14,19,398,43,11,66,3,3,126,19,9,36,3,0,67,68,9,68,0,7,152,1160,182,1492,88,160,3082
LGA33430,5356,480,706,12562,1521,412,1807,295,351,4386,509,158,603,125,126,1521,425,149,543,148,107,1372,290,26,187,31,50,584,13843,1639,11040,1295,1767,29584
LGA33610,14,3,3,27,0,0,0,0,0,0,0,0,0,0,0,0,0,0,0,0,0,0,18,0,22,3,5,48,256,33,301,15,28,633
LGA33620,33,3,0,68,0,4,3,0,0,7,0,3,0,3,0,6,0,0,3,3,0,6,35,3,19,3,3,63,739,121,808,62,81,1811
LGA33800,4,0,4,8,0,0,5,0,0,5,3,0,0,0,0,3,0,0,0,0,0,0,9,4,10,0,0,23,214,46,208,27,30,525
LGA33830,0,0,0,0,0,0,0,0,0,0,0,0,0,0,0,0,0,0,0,0,0,0,0,0,0,0,0,0,30,6,84,3,9,132
LGA33960,887,65,98,1706,56,23,108,19,7,213,14,9,23,0,0,46,19,8,25,7,0,59,92,17,89,7,22,227,3541,673,4734,328,550,9826
LGA33980,30,0,6,68,10,4,28,3,0,45,10,0,4,0,3,17,86,5,140,7,13,251,63,9,95,7,9,183,1007,166,1540,86,122,2921
LGA34420,0,0,0,0,0,0,0,0,0,0,0,0,0,0,0,0,0,0,0,0,0,0,4,0,0,0,0,4,45,9,78,4,9,145
LGA34570,0,0,0,0,0,0,0,0,0,0,0,0,0,0,0,0,0,0,0,0,0,0,3,0,0,0,0,3,25,3,27,0,3,58
LGA34580,58,0,4,119,3,0,8,0,0,11,3,0,3,0,0,6,0,0,3,0,0,3,22,3,18,3,0,46,543,93,604,43,51,1334
LGA34590,2302,210,301,4438,194,93,310,53,73,723,30,16,64,8,15,133,20,12,35,11,5,83,116,21,121,21,31,310,4663,1074,6365,596,929,13627
LGA34710,7,3,0,15,0,0,0,0,0,0,0,0,0,0,0,0,3,0,0,0,0,3,12,0,8,0,0,20,121,11,138,6,11,287
LGA34770,889,52,100,1897,326,78,548,36,42,1030,51,17,89,13,18,188,39,4,56,5,4,108,64,3,62,14,3,146,2453,271,2576,177,327,5804
LGA34800,0,0,0,0,0,0,0,0,0,0,0,0,0,0,0,0,0,0,0,0,0,0,0,0,8,0,0,8,15,0,27,0,0,42
LGA34830,0,0,0,0,0,0,0,0,0,0,0,0,0,0,0,0,0,0,0,0,0,0,0,0,0,0,0,0,16,0,14,0,3,33
LGA34860,31,4,3,73,13,5,12,0,0,30,3,3,3,0,5,14,0,0,9,0,0,9,16,0,28,0,0,44,304,31,358,14,36,743
LGA35010,2864,257,390,5736,261,142,459,68,69,999,71,40,142,26,29,308,55,18,80,10,21,184,170,24,145,21,34,394,7160,1271,8057,699,1181,18368
LGA35250,0,0,0,0,0,0,0,0,0,0,0,0,0,0,0,0,0,0,0,0,0,0,0,0,0,0,0,0,57,5,91,0,5,158
LGA35300,122,6,3,274,101,16,89,7,11,224,34,0,33,3,3,73,6,3,10,0,0,19,30,0,22,0,5,57,646,66,592,29,52,1385
LGA35600,0,0,0,0,0,0,0,0,0,0,0,0,0,0,0,0,0,0,0,0,0,0,4,3,10,0,3,20,113,20,148,0,6,287
LGA35670,0,0,0,0,0,0,0,0,0,0,0,0,0,0,0,0,0,0,0,0,0,0,0,0,0,0,0,0,26,15,57,4,11,113
LGA35760,0,0,0,0,0,0,0,0,0,0,0,0,0,0,0,0,0,0,0,0,0,0,9,0,19,0,0,28,197,19,201,9,20,446
LGA35780,0,0,0,0,0,0,0,0,0,0,0,0,0,0,0,0,3,0,0,0,0,3,0,0,3,0,0,3,73,28,173,4,23,301
LGA35790,0,0,0,0,0,0,0,0,0,0,0,0,0,0,0,0,0,0,0,0,0,0,4,0,0,0,0,4,46,16,146,3,25,236
LGA35800,0,0,0,0,0,0,0,0,0,0,0,0,0,0,0,0,0,0,0,0,0,0,0,0,8,0,0,8,33,4,54,3,9,103
LGA36070,0,0,0,0,0,0,0,0,0,0,0,0,0,0,0,0,0,0,0,0,0,0,0,0,0,0,0,0,49,0,51,0,6,106
LGA36150,0,0,0,0,0,0,0,0,0,0,3,0,0,0,0,3,0,0,0,0,0,0,5,0,3,0,0,8,30,0,29,0,3,62
LGA36250,1150,121,137,2385,267,124,497,82,89,1059,50,36,108,20,24,238,34,39,95,19,11,198,49,8,44,12,13,126,2146,475,2518,306,391,5836
LGA36300,0,0,0,0,0,0,0,0,0,0,0,0,0,0,0,0,0,0,0,0,0,0,3,0,3,0,0,6,26,4,27,0,0,57
LGA36360,512,32,53,986,50,15,88,10,13,176,8,0,17,4,0,29,9,6,12,0,4,31,69,11,57,6,13,156,2145,254,2295,143,303,5140
LGA36510,135,9,11,285,27,0,39,6,5,77,5,0,8,0,0,13,13,0,12,0,0,25,16,5,19,3,4,47,597,127,602,64,68,1458
LGA36580,35,0,5,67,6,0,0,0,0,6,0,0,0,0,3,3,7,0,0,0,0,7,17,0,10,0,0,27,378,54,372,27,40,871
LGA36630,35,5,4,68,0,0,0,0,0,0,0,0,3,0,0,3,3,0,3,0,0,6,15,0,17,0,3,35,562,66,584,36,72,1320
LGA36660,12,0,4,25,0,0,0,0,0,0,0,0,0,0,0,0,8,0,0,0,0,8,25,3,17,4,0,49,622,75,645,48,69,1459
LGA36710,2891,257,343,6082,518,194,924,113,120,1869,142,61,246,44,31,524,120,41,183,24,19,387,152,24,93,13,27,309,6748,926,6190,628,834,15326
LGA36810,84,3,3,133,3,0,5,0,0,8,0,0,0,0,0,0,3,3,0,3,0,9,37,3,28,0,11,79,767,110,798,47,76,1798
LGA36910,443,39,33,817,32,16,49,8,4,109,6,0,10,0,0,16,18,0,17,0,3,38,82,16,69,11,15,193,2904,424,3168,244,376,7116
LGA36950,3,0,3,12,0,0,3,0,6,9,0,0,0,0,0,0,0,0,4,0,0,4,15,5,9,3,0,32,116,45,187,15,24,387
LGA36960,0,0,0,0,0,0,0,0,0,0,0,0,0,0,0,0,0,0,0,0,0,0,8,0,10,0,3,21,100,18,337,5,46,506
LGA37010,1314,138,126,3006,207,46,234,28,25,540,32,13,76,13,7,141,34,3,36,5,4,82,104,17,105,11,10,247,4618,573,4304,356,439,10290
LGA37300,17,0,5,38,28,0,17,5,3,53,6,3,24,0,4,37,8,0,15,0,0,23,8,3,13,0,0,24,169,15,179,13,15,391
LGA37310,118,5,5,198,19,0,26,0,0,45,0,0,0,3,0,3,3,0,3,0,0,6,38,8,45,0,7,98,653,97,799,32,61,1642
LGA37340,182,8,22,402,50,4,81,3,9,147,13,0,16,0,3,32,13,0,17,0,3,33,35,4,17,0,4,60,874,63,714,40,88,1779
LGA37400,0,0,0,0,0,0,0,0,0,0,0,0,0,0,0,0,0,0,0,0,0,0,5,0,4,0,0,9,35,4,31,0,0,70
LGA37550,0,0,0,3,0,0,0,0,0,0,0,0,0,0,0,0,0,0,0,0,0,0,0,0,0,0,0,0,23,6,53,0,7,89
LGA37570,0,0,0,0,0,0,0,0,0,0,0,0,0,0,0,0,0,0,0,0,0,0,0,0,0,0,0,0,10,0,29,0,9,48
LGA37600,0,0,0,0,0,0,0,0,0,0,0,0,0,0,0,0,0,0,0,0,0,0,0,0,0,0,0,0,51,21,137,4,22,235
LGA39399,0,0,0,0,0,0,0,0,0,0,0,0,0,0,0,0,0,0,0,0,0,0,0,0,0,0,0,0,0,0,0,0,0,0
LGA40070,75,3,3,423,119,0,35,5,6,165,40,0,13,3,0,56,38,4,17,4,3,66,19,0,3,3,0,25,976,7,258,25,18,1284
LGA40120,77,7,9,151,13,7,28,5,3,56,3,3,11,0,0,17,3,3,5,4,0,15,15,0,3,5,0,23,327,44,307,46,35,759
LGA40220,20,3,5,43,0,0,0,0,0,0,0,0,3,0,0,3,3,0,3,0,0,6,10,0,9,0,4,23,406,49,304,26,30,815
LGA40250,3,0,0,3,0,0,0,0,0,0,0,0,0,0,0,0,0,0,0,0,0,0,6,0,8,0,0,14,119,22,160,9,15,325
LGA40310,29,4,0,40,3,0,3,0,0,6,3,0,3,0,0,6,3,0,0,0,0,3,5,0,9,0,3,17,324,24,284,27,40,699
LGA40430,0,0,0,0,3,0,0,0,0,3,0,0,0,0,0,0,0,0,0,0,0,0,0,0,3,0,0,3,47,3,22,0,0,72
LGA40520,3,0,0,3,0,0,0,0,0,0,0,0,0,0,0,0,0,0,0,0,0,0,8,0,5,0,0,13,207,15,164,13,25,424
LGA40700,109,30,11,271,52,17,80,16,6,171,17,8,46,10,0,81,14,20,54,8,5,101,14,5,3,3,4,29,665,110,500,90,41,1406
LGA40910,174,33,27,376,20,11,30,9,3,73,0,0,10,0,0,10,4,0,7,0,0,11,35,4,10,0,3,52,863,110,819,110,83,1985
LGA41010,4,0,0,4,0,0,0,0,0,0,0,0,0,0,0,0,0,0,0,0,0,0,4,0,4,0,0,8,98,12,104,0,12,226
LGA41060,296,43,44,757,50,15,73,9,11,158,24,13,28,8,0,73,23,6,21,4,7,61,47,3,28,8,11,97,2174,240,1577,192,278,4461
LGA41140,3,0,0,8,3,0,0,0,0,3,4,0,0,0,0,4,0,0,0,0,0,0,11,3,8,0,0,22,161,18,135,12,13,339
LGA41190,0,0,0,0,0,0,0,0,0,0,0,0,0,0,0,0,3,0,0,0,0,3,0,0,0,0,0,0,52,0,23,0,3,78
LGA41330,3,0,0,6,0,0,0,0,0,0,0,0,0,0,0,0,0,0,0,0,0,0,0,0,3,0,0,3,53,9,42,4,6,114
LGA41560,9,0,0,9,0,0,0,0,0,0,0,0,0,0,0,0,0,0,0,0,0,0,5,0,0,3,0,8,227,21,201,16,18,483
LGA41750,0,0,0,0,0,0,0,0,0,0,0,0,0,0,0,0,0,0,0,0,3,3,0,0,5,0,0,5,21,0,20,0,3,44
LGA41830,0,0,0,0,0,0,0,0,0,0,0,0,0,0,0,0,3,0,0,0,0,3,3,0,3,0,0,6,30,0,14,0,4,48
LGA41960,0,0,0,0,0,0,0,0,0,0,0,0,0,0,0,0,0,0,0,0,0,0,0,0,0,0,0,0,28,3,20,0,3,54
LGA42030,21,3,3,47,3,0,3,0,0,6,3,0,0,0,0,3,0,0,0,0,0,0,11,3,8,0,0,22,365,44,296,32,44,781
LGA42110,0,0,0,0,0,0,0,0,0,0,0,0,3,0,0,3,0,0,0,0,0,0,6,0,0,0,0,6,69,6,54,0,9,138
LGA42250,3,0,0,3,0,0,4,0,0,4,0,0,0,0,0,0,0,0,0,0,0,0,3,0,11,3,0,17,69,10,82,9,8,178
LGA42600,120,18,17,324,62,7,52,13,6,140,24,7,25,4,11,71,23,9,29,5,5,71,17,0,7,0,0,24,915,55,462,66,67,1565
LGA42750,0,0,0,0,0,0,0,0,0,0,0,0,0,0,0,0,0,0,0,0,0,0,3,0,0,0,0,3,99,6,72,4,7,188
LGA43080,0,0,0,0,0,0,0,0,0,0,0,0,0,0,0,0,0,0,0,0,0,0,3,0,3,0,0,6,14,6,19,0,0,39
LGA43220,0,0,0,0,0,0,0,0,0,0,0,0,0,0,0,0,0,0,0,0,0,0,0,0,0,0,0,0,22,0,16,0,3,41
LGA43360,0,0,0,0,0,0,0,0,0,0,0,0,0,0,0,0,0,0,0,0,0,0,5,0,5,0,0,10,52,9,43,4,3,111
LGA43650,20,6,3,44,3,0,0,0,3,6,0,0,0,0,0,0,0,0,0,0,0,0,5,3,3,3,0,14,136,30,145,15,19,345
LGA43710,3,0,0,6,3,3,0,0,0,6,0,0,0,0,0,0,0,0,0,0,0,0,3,3,3,0,0,9,58,16,78,6,3,161
LGA43790,3,0,0,3,0,0,0,0,0,0,0,0,0,0,0,0,3,0,0,0,0,3,4,3,5,0,3,15,208,23,148,19,20,418
LGA43920,10,0,0,13,0,0,0,0,0,0,0,0,3,0,0,3,0,0,0,0,0,0,3,0,0,0,0,3,56,12,66,3,15,152
LGA44000,0,0,0,0,0,0,0,0,0,0,0,0,0,0,0,0,0,0,0,0,0,0,3,0,0,0,0,3,8,0,5,0,0,13
LGA44060,315,44,36,697,24,10,35,12,0,81,6,4,12,0,4,26,6,3,15,0,4,28,42,3,25,7,3,80,1637,157,1195,165,169,3323
LGA44210,0,0,0,0,0,0,0,0,0,0,0,0,0,0,0,0,0,0,0,3,0,3,4,0,6,0,3,13,121,11,76,6,21,235
LGA44340,140,19,13,328,22,18,48,15,9,112,9,4,22,4,6,45,9,3,19,4,3,38,29,3,12,0,0,44,786,100,634,86,71,1677
LGA44550,110,6,7,200,10,4,15,0,4,33,3,0,3,3,0,9,3,0,9,0,0,12,9,3,8,0,3,23,459,71,431,54,48,1063
LGA44620,5,0,0,16,0,0,0,0,0,0,0,0,0,0,0,0,3,0,0,0,0,3,9,3,6,0,0,18,517,66,400,30,57,1070
LGA44830,0,0,0,0,0,0,0,0,0,0,0,0,0,0,0,0,0,0,0,0,0,0,3,0,3,0,0,6,39,9,23,4,0,75
LGA45040,3,0,0,7,3,0,3,0,0,6,0,0,0,0,0,0,0,3,3,0,0,6,10,0,18,0,0,28,407,69,401,33,52,962
LGA45090,4,0,0,4,0,0,0,0,0,0,0,0,0,0,0,0,0,0,0,0,0,0,11,0,7,0,3,21,161,15,161,8,15,360
LGA45120,3,0,0,3,0,0,0,0,0,0,0,0,0,0,0,0,3,0,0,0,0,3,6,0,4,0,0,10,75,6,48,0,3,132
LGA45290,122,17,10,363,61,3,48,5,6,123,12,3,26,3,3,47,14,4,31,0,3,52,26,3,12,0,0,41,1095,54,555,62,37,1803
LGA45340,341,36,40,670,16,17,38,5,3,79,4,3,10,0,4,21,14,3,9,5,3,34,72,6,41,5,8,132,2134,342,2054,207,283,5020
LGA45400,0,0,0,0,0,0,0,0,0,0,0,0,0,0,0,0,0,0,0,0,0,0,4,0,0,0,0,4,7,3,10,0,0,20
LGA45540,0,0,0,0,0,0,0,0,0,0,0,0,0,0,0,0,0,0,0,0,0,0,3,0,3,0,0,6,17,0,11,3,3,34
LGA45680,50,6,8,101,0,4,4,0,4,12,0,0,0,0,0,0,0,0,4,0,0,4,43,0,34,4,10,91,1496,223,1424,128,238,3509
LGA45890,323,31,27,774,25,6,33,5,7,76,10,8,9,4,0,31,11,7,10,0,4,32,70,9,48,5,10,142,2732,299,2114,198,296,5639
LGA46090,4,0,0,15,3,0,0,0,0,3,0,0,0,0,0,0,0,0,0,0,0,0,8,0,11,0,0,19,281,21,229,19,30,580
LGA46300,31,0,0,49,3,0,3,0,0,6,0,0,0,0,0,0,0,0,0,0,0,0,9,0,4,0,4,17,312,38,279,16,50,695
LGA46450,6,0,0,17,3,0,0,0,0,3,0,0,0,0,0,0,0,0,0,0,0,0,14,4,3,0,0,21,326,27,222,17,20,612
LGA46510,56,10,3,148,12,4,26,8,3,53,4,0,10,3,0,17,0,0,3,0,0,3,16,0,4,0,3,23,495,23,333,33,22,906
LGA46670,0,0,0,3,0,0,0,0,0,0,0,0,0,0,0,0,3,0,0,0,0,3,3,0,5,5,0,13,182,22,129,17,18,368
LGA46860,0,0,0,0,0,0,0,0,0,0,0,0,0,0,0,0,5,0,0,0,0,5,3,0,0,0,0,3,44,4,26,0,3,77
LGA46970,36,5,6,101,30,0,36,0,5,71,8,5,16,0,0,29,6,0,7,0,0,13,10,3,8,0,3,24,250,25,302,16,20,613
LGA47140,177,10,26,380,25,14,47,4,7,97,9,5,4,0,0,18,6,0,12,4,3,25,64,7,48,9,11,139,2061,330,1956,205,326,4878
LGA47290,0,0,0,0,0,0,0,0,0,0,0,0,0,0,0,0,0,0,0,0,0,0,0,0,4,0,0,4,37,6,40,3,0,86
LGA47490,0,0,0,0,0,0,0,0,0,0,0,0,0,0,0,0,0,0,0,0,0,0,0,0,0,0,0,0,39,3,40,3,0,85
LGA47630,3,0,0,3,0,0,0,0,0,0,0,0,0,0,0,0,0,0,0,0,0,0,8,3,5,0,0,16,117,15,129,13,12,286
LGA47700,181,26,23,348,9,6,14,0,3,32,0,4,3,0,3,10,3,6,4,0,0,13,37,0,19,0,3,59,1065,162,992,110,155,2484
LGA47800,0,0,0,0,0,0,3,0,0,3,0,0,0,0,0,0,0,0,0,0,3,3,4,3,6,3,0,16,85,14,102,9,15,225
LGA47910,0,0,0,0,0,0,0,0,0,0,0,0,0,0,0,0,0,0,0,0,0,0,5,6,0,0,0,11,58,6,42,0,6,112
LGA47980,92,17,6,295,56,12,82,7,6,163,28,5,37,3,5,78,19,5,45,6,4,79,21,0,7,3,0,31,929,58,518,60,44,1609
LGA48050,3,0,0,13,0,0,0,0,0,0,0,0,0,0,0,0,3,0,0,0,0,3,8,4,4,0,0,16,285,35,169,18,20,527
LGA48130,3,0,0,3,0,0,0,0,0,0,0,0,0,0,0,0,3,0,0,0,0,3,3,0,3,0,3,9,98,14,87,8,9,216
LGA48260,5,0,0,32,4,4,20,0,3,31,3,0,6,3,3,15,3,0,16,4,3,26,5,0,0,0,0,5,119,7,82,10,13,231
LGA48340,0,0,0,0,0,0,0,0,0,0,0,0,0,0,0,0,3,0,3,0,0,6,8,0,3,0,0,11,182,18,137,11,11,359
LGA48410,161,19,23,472,40,3,36,5,0,84,14,3,6,3,0,26,9,3,7,3,0,22,37,3,21,3,5,69,1603,111,956,89,105,2864
LGA48540,29,5,3,64,3,0,3,0,0,6,0,0,0,0,0,0,3,0,0,0,0,3,21,0,7,3,3,34,555,52,334,34,46,1021
LGA48640,0,0,0,0,0,0,0,0,0,0,0,0,0,0,0,0,0,0,0,0,0,0,0,0,0,0,0,0,23,0,39,0,0,62
LGA48750,3,0,0,6,0,0,0,0,0,0,0,0,0,0,0,0,3,0,0,0,0,3,4,0,0,0,0,4,74,12,54,6,6,152
LGA48830,0,0,0,0,0,0,0,0,0,0,0,0,3,0,0,3,3,0,3,0,0,6,18,0,5,0,3,26,185,19,144,12,12,372
LGA49399,3,0,0,3,0,0,0,0,0,0,0,0,0,0,0,0,3,0,3,0,0,6,12,3,7,0,0,22,180,19,131,10,12,352
LGA50080,118,7,15,225,0,3,10,3,0,16,3,0,3,0,0,6,3,3,3,0,0,9,31,3,14,4,3,55,701,108,724,63,68,1664
LGA50210,201,19,25,395,47,18,85,10,9,169,6,9,11,3,0,29,8,0,0,4,0,12,23,0,22,3,5,53,830,129,975,73,124,2131
LGA50250,4,0,0,4,0,3,3,0,0,6,3,0,0,0,3,6,7,0,3,0,0,10,28,0,29,0,0,57,395,48,630,20,39,1132
LGA50280,66,0,0,108,0,0,3,3,0,6,0,0,0,0,0,0,0,0,3,0,0,3,14,0,8,0,0,22,294,34,323,22,9,682
LGA50350,87,9,12,203,10,4,18,3,0,35,3,0,0,0,0,3,3,0,0,0,0,3,6,0,3,0,7,16,299,37,215,21,37,609
LGA50420,372,39,48,993,108,16,85,15,11,235,26,6,23,0,3,58,15,8,14,6,5,48,37,6,22,6,0,71,1739,123,1089,105,138,3194
LGA50490,268,30,39,705,101,3,77,10,16,207,37,0,12,0,3,52,15,3,12,0,0,30,28,6,13,0,3,50,1069,103,805,65,127,2169
LGA50560,3,0,0,3,0,0,0,0,0,0,0,0,0,0,0,0,0,0,0,0,0,0,0,0,3,0,0,3,23,3,26,0,0,52
LGA50630,16,0,0,25,4,4,6,0,0,14,0,0,4,0,0,4,0,0,0,0,0,0,3,0,4,0,0,7,43,4,59,3,6,115
LGA50770,0,0,0,0,0,0,0,0,0,0,0,0,0,0,0,0,0,0,0,0,0,0,0,0,3,0,0,3,25,3,24,0,3,55
LGA50840,3,0,0,6,0,0,0,0,0,0,0,0,0,0,0,0,0,0,0,0,0,0,3,0,3,0,0,6,74,7,71,0,3,155
LGA50910,0,0,0,0,0,0,0,0,0,0,0,0,0,0,0,0,0,0,0,0,0,0,0,0,0,0,0,0,21,3,22,0,3,49
LGA50980,33,4,4,114,48,3,36,0,4,91,51,3,37,3,3,97,88,12,83,4,6,193,34,0,31,0,6,71,608,66,591,40,65,1370
LGA51080,0,0,0,0,0,0,0,0,0,0,0,0,0,0,0,0,0,0,0,0,0,0,4,0,4,0,0,8,27,5,25,3,6,66
LGA51120,0,0,0,0,0,0,0,0,0,0,0,0,0,0,0,0,4,0,0,0,0,4,0,0,3,0,0,3,20,4,28,0,0,52
LGA51190,94,11,12,209,20,3,28,3,3,57,12,0,14,0,0,26,9,3,8,8,0,28,26,0,5,0,0,31,821,66,634,50,75,1646
LGA51260,190,9,18,374,12,8,21,3,0,44,3,0,3,0,0,6,6,3,0,0,0,9,16,3,19,0,3,41,764,105,742,61,66,1738
LGA51310,51,5,5,163,83,4,68,11,6,172,34,8,51,9,0,102,40,34,176,25,6,281,3,0,3,5,0,11,459,64,421,58,23,1025
LGA51330,691,85,45,1623,110,38,189,42,29,408,24,12,38,7,3,84,16,12,29,8,3,68,54,6,31,3,4,98,1683,335,1668,202,147,4035
LGA51400,160,8,9,269,8,4,19,0,0,31,0,3,3,0,0,6,0,0,3,0,3,6,4,0,7,0,4,15,201,46,337,15,34,633
LGA51470,0,0,0,0,0,0,0,0,0,0,0,0,0,0,0,0,0,0,0,0,0,0,3,0,3,0,0,6,13,0,19,0,0,32
LGA51540,12,0,0,17,5,0,4,0,0,9,0,0,0,0,0,0,3,0,3,0,0,6,14,0,9,0,0,23,173,12,193,4,17,399
LGA51610,0,0,0,0,0,0,3,0,0,3,0,0,0,0,0,0,0,0,0,0,0,0,4,0,0,0,0,4,25,0,13,3,0,41
LGA51680,6,3,3,17,3,0,8,0,0,11,0,0,3,0,0,3,0,0,0,0,0,0,3,0,0,0,0,3,39,4,36,6,9,94
LGA51750,25,4,0,89,36,5,22,0,0,63,27,3,14,3,0,47,34,16,71,7,5,133,3,0,4,4,0,11,223,35,161,22,8,449
LGA51820,621,57,81,1441,103,44,234,33,22,436,22,8,33,5,3,71,26,3,29,7,7,72,39,6,35,0,14,94,1470,218,1458,141,200,3487
LGA51890,11,3,0,24,0,0,5,0,0,5,0,0,0,0,0,0,0,0,3,0,3,6,3,0,3,3,0,9,128,16,109,12,11,276
LGA51960,0,0,0,0,0,0,0,0,0,0,0,0,0,0,0,0,3,0,0,0,0,3,0,0,4,0,0,4,95,15,129,6,15,260
LGA52030,0,0,0,0,0,0,0,0,0,0,0,0,0,0,0,0,0,0,0,0,0,0,4,0,3,0,0,7,30,0,22,0,3,55
LGA52100,0,0,0,0,0,0,0,0,0,0,0,0,0,0,0,0,0,0,0,0,0,0,0,0,0,0,0,0,27,0,18,6,0,51
LGA52170,10,0,0,52,48,3,7,0,0,58,23,0,11,0,6,40,44,7,92,13,5,161,3,6,0,3,0,12,217,22,120,19,11,389
LGA52240,0,0,0,0,0,0,0,0,0,0,0,0,0,0,0,0,0,0,0,0,0,0,3,0,3,0,3,9,19,3,32,3,3,60
LGA52310,0,0,0,0,0,0,0,0,0,0,0,0,0,0,0,0,0,0,0,0,0,0,3,0,0,0,0,3,14,6,9,0,0,29
LGA52380,0,0,0,0,0,0,0,0,0,0,0,0,0,0,0,0,0,0,0,0,0,0,0,0,3,0,0,3,11,0,6,0,0,17
LGA52450,0,0,0,0,0,0,0,0,0,0,0,0,0,0,0,0,0,0,0,0,0,0,4,0,4,0,0,8,31,3,29,0,0,63
LGA52520,0,0,0,0,0,0,0,0,0,0,0,0,0,0,0,0,0,0,0,0,0,0,5,0,0,0,0,5,37,4,26,0,3,70
LGA52590,9,0,0,13,0,0,0,0,0,0,0,0,0,0,0,0,0,0,0,0,0,0,4,0,6,0,0,10,86,0,95,3,6,190
LGA52660,86,7,5,149,3,0,0,0,0,3,0,0,0,0,0,0,3,0,0,0,0,3,5,0,5,0,0,10,215,32,241,15,24,527
LGA52730,4,0,5,14,0,0,3,0,0,3,0,0,0,0,0,0,0,0,0,0,0,0,3,0,4,0,0,7,102,15,108,10,5,240
LGA52800,7,0,0,10,4,3,7,0,0,14,3,3,6,0,0,12,3,3,5,0,0,11,12,3,18,3,5,41,238,22,365,12,27,664
LGA52870,7,0,0,7,0,0,0,0,0,0,0,0,0,0,0,0,0,0,0,0,0,0,3,0,3,0,0,6,43,4,74,6,9,136
LGA52940,0,0,0,0,0,0,0,0,0,0,0,0,0,0,0,0,0,0,0,0,0,0,3,0,3,0,0,6,21,0,22,0,0,43
LGA53010,0,0,0,0,0,0,0,0,0,0,0,0,0,0,0,0,0,0,0,0,0,0,0,0,0,0,0,0,14,3,9,0,3,29
LGA53080,0,0,0,0,0,0,0,0,0,0,0,0,0,0,0,0,0,0,0,0,0,0,3,0,4,0,0,7,34,0,33,3,3,73
LGA53150,17,3,3,73,23,3,17,3,0,46,7,3,8,3,3,24,14,3,25,3,5,50,3,0,5,0,0,8,135,15,102,12,11,275
LGA53220,3,0,0,6,0,0,5,0,0,5,0,0,3,0,0,3,15,0,10,0,0,25,34,5,64,6,4,113,324,47,473,11,53,908
LGA53290,43,6,7,82,3,0,7,0,3,13,3,0,0,0,3,6,0,0,0,0,0,0,7,0,21,4,3,35,295,48,353,22,42,760
LGA53360,23,0,3,44,11,0,13,0,0,24,3,0,4,0,0,7,3,0,3,3,0,9,0,0,5,0,3,8,115,3,88,6,12,224
LGA53430,91,6,9,308,137,8,51,4,6,206,58,0,30,4,3,95,43,10,35,8,3,99,23,0,7,0,0,30,798,40,355,31,49,1273
LGA53520,217,18,25,435,27,3,46,6,0,82,3,3,6,0,0,12,4,0,6,0,0,10,26,5,23,4,0,58,757,102,805,63,87,1814
LGA53570,13,4,0,25,0,0,0,0,0,0,0,0,0,0,0,0,0,0,0,0,0,0,7,0,3,0,0,10,83,14,80,4,9,190
LGA53640,0,0,0,0,0,0,0,0,0,0,0,0,0,0,0,0,0,0,0,0,0,0,0,0,6,0,0,6,27,3,28,0,3,61
LGA53710,0,0,0,0,0,0,0,0,0,0,0,0,0,0,0,0,0,0,0,0,0,0,3,0,4,0,0,7,18,4,17,0,3,42
LGA53780,648,57,87,1319,92,43,191,28,32,386,7,5,19,9,3,43,16,6,16,0,4,42,36,8,44,5,8,101,1407,284,1852,173,255,3971
LGA53920,3,0,0,3,0,0,3,0,0,3,0,0,0,0,0,0,0,0,0,0,0,0,7,4,10,0,0,21,112,23,200,6,19,360
LGA53990,141,7,15,249,3,4,13,0,0,20,0,0,3,0,0,3,4,0,4,0,0,8,9,4,8,0,0,21,379,74,468,21,70,1012
LGA54060,14,0,0,17,0,0,0,0,0,0,0,0,0,0,0,0,0,0,0,0,0,0,3,0,3,3,0,9,73,12,99,12,15,211
LGA54130,0,0,0,0,0,0,0,0,0,0,0,0,0,0,0,0,0,0,0,0,0,0,4,0,3,0,3,10,26,0,34,3,6,69
LGA54170,942,93,133,2087,195,108,412,63,56,834,67,42,199,30,14,352,77,47,181,42,18,365,41,7,29,3,9,89,1933,357,2170,273,286,5019
LGA54200,267,25,36,549,40,16,76,11,17,160,10,3,15,0,0,28,5,3,9,3,3,23,17,4,10,4,3,38,567,94,608,69,93,1431
LGA54280,226,8,22,432,58,15,88,3,4,168,18,6,40,3,7,74,5,0,13,3,3,24,26,5,29,3,3,66,836,98,880,55,96,1965
LGA54340,3,0,0,3,0,0,0,0,0,0,0,0,0,0,0,0,0,0,0,0,0,0,5,0,3,0,0,8,88,16,123,6,9,242
LGA54410,0,0,0,0,0,0,0,0,0,0,0,0,0,0,0,0,0,0,0,0,0,0,0,0,0,0,0,0,26,0,24,0,6,56
LGA54480,0,0,0,0,0,0,0,0,0,0,0,0,0,0,0,0,0,0,0,0,0,0,0,0,3,0,0,3,15,0,11,0,0,26
LGA54550,0,0,0,0,0,0,0,0,0,0,0,0,0,0,0,0,0,0,0,0,0,0,3,0,5,0,0,8,53,0,46,3,13,115
LGA54620,0,0,0,0,0,0,0,0,0,0,0,0,0,0,0,0,3,0,0,0,0,3,3,0,0,0,0,3,31,0,22,0,0,53
LGA54690,0,0,0,0,0,0,0,0,0,0,0,0,0,0,0,0,0,0,0,0,0,0,0,0,0,0,0,0,12,0,18,0,0,30
LGA54760,0,0,0,0,0,0,0,0,0,0,0,0,0,0,0,0,0,0,0,0,0,0,0,0,0,0,0,0,16,4,21,0,0,41
LGA54830,146,3,14,298,10,4,10,0,0,24,0,0,3,3,0,6,5,0,0,0,0,5,14,0,7,0,5,26,518,81,523,19,72,1213
LGA54900,3,0,0,3,0,0,0,0,0,0,0,0,0,0,0,0,0,0,0,0,0,0,3,3,3,3,0,12,31,9,44,3,3,90
LGA54970,0,0,0,0,0,0,0,0,0,0,0,0,0,0,0,0,0,0,0,0,0,0,0,0,0,0,0,0,35,6,36,0,3,80
LGA55040,0,0,0,4,0,0,3,0,0,3,0,0,0,0,0,0,0,0,0,0,0,0,8,0,13,0,0,21,73,4,105,10,6,198
LGA55110,415,34,59,840,31,14,49,12,15,121,11,0,15,5,3,34,20,5,12,3,3,43,29,5,19,0,0,53,1627,230,1539,122,196,3714
LGA55180,3,0,0,6,0,0,0,0,0,0,0,0,0,0,0,0,0,0,0,0,0,0,14,0,3,3,0,20,149,16,158,9,13,345
LGA55250,0,0,3,3,0,0,0,0,0,0,0,3,0,0,0,3,0,0,0,0,0,0,15,0,0,0,0,15,52,3,32,0,7,94
LGA55320,473,70,42,1192,188,61,288,62,27,626,70,29,112,31,14,256,84,51,188,49,24,396,32,4,31,10,7,84,1622,243,1450,249,170,3734
LGA55390,0,0,0,0,0,0,0,0,0,0,0,0,0,0,0,0,0,0,0,0,0,0,0,0,0,0,0,0,9,0,12,3,6,30
LGA55460,5,3,0,11,0,0,3,0,0,3,0,0,0,0,0,0,0,0,0,0,0,0,5,0,3,0,0,8,69,3,69,12,5,158
LGA55530,0,0,0,0,0,0,0,0,0,0,0,0,0,0,0,0,0,0,0,0,0,0,0,0,7,0,0,7,9,0,23,0,0,32
LGA55600,3,0,0,3,0,0,0,0,0,0,0,0,0,0,0,0,3,0,0,0,0,3,3,0,3,0,0,6,48,3,56,6,6,119
LGA55670,0,0,0,0,0,0,0,0,0,0,0,0,0,0,0,0,0,0,0,0,0,0,0,0,4,0,0,4,19,4,29,3,0,55
LGA55740,21,0,0,103,18,0,25,3,0,46,9,0,11,7,0,27,15,13,54,12,4,98,5,0,3,0,0,8,254,19,166,22,4,465
LGA55810,0,0,0,0,0,0,0,0,0,0,0,0,0,0,0,0,0,0,0,0,0,0,3,0,0,0,3,6,28,4,17,0,6,55
LGA55880,0,0,0,0,0,0,0,0,0,0,0,0,0,0,0,0,0,0,0,0,0,0,4,0,0,0,0,4,13,3,11,0,0,27
LGA55950,0,0,0,0,0,0,0,0,0,0,0,0,0,0,0,0,0,0,0,0,0,0,3,0,0,0,0,3,22,0,12,3,0,37
LGA56020,0,0,0,0,0,0,0,0,0,0,0,0,0,0,0,0,0,0,0,0,0,0,3,0,0,0,0,3,18,0,15,3,0,36
LGA56090,107,20,9,222,21,8,54,8,6,97,10,0,12,0,0,22,9,0,5,0,0,14,9,0,12,0,0,21,313,52,316,32,46,759
LGA56160,0,0,0,0,0,0,0,0,0,0,0,0,0,0,0,0,0,0,0,0,0,0,0,0,0,0,0,0,11,0,3,0,3,17
LGA56230,60,3,12,114,3,3,7,0,6,19,0,4,0,0,0,4,0,0,4,0,0,4,12,0,8,0,0,20,239,19,226,16,40,540
LGA56300,0,0,0,0,0,0,0,0,0,0,0,0,0,0,0,0,0,0,0,0,0,0,0,0,3,0,3,6,25,0,18,6,3,52
LGA56370,0,0,0,0,0,0,0,0,0,0,0,0,0,0,0,0,0,0,0,0,0,0,3,0,3,0,0,6,25,3,20,0,0,48
LGA56450,0,0,0,0,0,0,0,0,0,0,0,0,0,0,0,0,3,0,0,0,0,3,0,0,3,0,0,3,7,0,21,0,0,28
LGA56520,3,0,0,8,3,3,0,0,0,6,0,0,3,0,0,3,0,0,0,0,0,0,4,0,6,0,3,13,81,16,101,3,7,208
LGA56580,39,6,6,101,38,8,42,7,3,98,19,8,38,8,3,76,49,52,221,44,8,374,10,0,17,0,0,27,269,79,474,68,26,916
LGA56620,0,0,0,0,0,0,0,0,0,0,0,0,0,0,0,0,0,0,0,0,0,0,6,0,0,3,0,9,66,3,109,3,13,194
LGA56730,8,0,3,25,0,0,7,0,0,7,3,0,0,0,0,3,0,0,0,0,0,0,3,0,5,0,0,8,159,27,161,8,21,376
LGA56790,3,0,0,3,0,0,0,0,0,0,0,0,0,0,0,0,0,0,0,0,0,0,3,0,3,0,0,6,85,6,66,0,5,162
LGA56860,0,0,0,0,0,0,0,0,0,0,0,0,0,0,0,0,0,0,0,0,0,0,0,0,0,0,0,0,7,3,0,0,0,10
LGA56930,0,0,0,0,3,0,0,0,3,6,0,0,0,0,0,0,3,4,16,5,0,28,0,0,5,0,0,5,17,4,25,5,3,54
LGA57000,0,0,0,0,0,0,0,0,0,0,0,0,0,0,0,0,0,0,0,0,0,0,0,0,0,0,0,0,16,0,18,0,0,34
LGA57080,52,0,0,380,382,3,42,3,8,438,180,0,38,3,4,225,196,4,61,3,8,272,27,0,5,3,3,38,1408,11,257,21,30,1727
LGA57140,0,0,0,0,0,0,0,0,0,0,0,0,0,0,0,0,0,0,0,0,0,0,0,0,3,0,0,3,17,3,28,0,3,51
LGA57210,0,0,0,0,0,0,0,0,0,0,0,0,0,0,0,0,0,0,0,0,0,0,4,0,5,0,0,9,78,14,92,8,3,195
LGA57280,7,0,5,16,10,0,3,0,0,13,6,0,3,6,0,15,158,15,122,9,28,332,77,6,81,10,4,178,701,61,736,50,107,1655
LGA57350,0,0,0,0,0,0,0,0,0,0,0,0,0,0,0,0,0,0,0,0,0,0,0,0,3,0,0,3,14,3,19,0,6,42
LGA57420,15,0,0,23,0,0,0,0,0,0,4,0,0,0,0,4,0,0,0,0,0,0,3,0,10,0,3,16,74,3,110,0,6,193
LGA57490,877,68,83,1621,39,23,124,4,19,209,9,5,23,4,0,41,9,3,21,0,0,33,50,4,33,3,6,96,1883,349,2427,159,251,5069
LGA57560,24,3,3,61,20,3,29,0,4,56,8,7,14,0,0,29,203,17,171,10,27,428,118,17,166,10,27,338,1043,151,1240,84,188,2706
LGA57630,0,0,0,0,0,0,0,0,0,0,0,0,0,0,0,0,0,0,0,0,0,0,0,0,0,0,0,0,10,0,0,0,0,10
LGA57700,90,9,3,162,10,4,18,5,3,40,6,3,4,0,0,13,3,0,8,0,0,11,5,0,9,0,0,14,174,29,217,18,27,465
LGA57770,0,0,0,0,0,0,0,0,0,0,0,0,0,0,0,0,3,0,3,0,0,6,5,0,9,0,0,14,46,0,42,0,0,88
LGA57840,169,16,30,687,193,13,116,16,9,347,66,10,64,7,10,157,102,9,128,22,12,273,20,0,14,6,0,40,1525,74,728,90,91,2508
LGA57910,1145,76,87,3142,448,60,367,37,37,949,139,35,183,27,26,410,134,52,248,37,25,496,114,8,99,5,15,241,5510,486,3803,326,346,10471
LGA57980,61,5,0,241,122,5,67,7,7,208,88,5,55,5,0,153,97,6,111,18,7,239,17,0,10,0,0,27,791,23,436,47,21,1318
LGA58050,726,65,88,1491,74,48,145,26,29,322,20,4,38,5,9,76,13,0,31,3,3,50,34,18,39,3,6,100,1475,282,1729,161,240,3887
LGA58190,0,0,0,0,0,0,0,0,0,0,0,0,0,0,0,0,0,0,0,0,0,0,0,0,3,0,0,3,3,0,13,0,0,16
LGA58260,0,0,0,0,0,0,0,0,0,0,0,0,0,0,0,0,0,0,0,0,0,0,3,0,4,0,0,7,20,0,21,0,0,41
LGA58330,9,0,4,19,0,0,3,0,0,3,0,0,0,0,0,0,0,0,0,0,0,0,7,0,0,0,0,7,41,9,52,3,10,115
LGA58400,0,0,0,0,0,0,0,0,0,0,0,0,0,0,0,0,0,0,0,0,0,0,0,0,0,0,0,0,6,0,7,0,0,13
LGA58470,0,0,0,0,0,0,0,0,0,0,0,0,0,0,0,0,0,0,0,0,0,0,4,0,0,0,0,4,8,0,14,0,0,22
LGA58510,239,15,24,785,107,4,68,6,7,192,54,0,22,4,8,88,47,3,25,5,4,84,29,7,8,0,0,44,1435,61,716,59,66,2337
LGA58540,0,0,0,0,0,0,0,0,0,0,0,0,0,0,0,0,0,0,0,0,0,0,0,0,7,0,0,7,20,3,30,0,4,57
LGA58570,121,8,14,624,300,3,81,3,8,395,71,0,39,5,4,119,69,5,42,10,3,129,28,4,9,0,3,44,1423,43,440,38,45,1989
LGA58610,0,0,0,0,0,0,0,0,0,0,0,0,0,0,0,0,0,0,0,0,0,0,3,0,3,0,0,6,33,6,31,6,3,79
LGA58680,0,0,0,0,0,0,0,0,0,0,0,0,0,0,0,0,0,0,0,0,0,0,0,0,0,0,0,0,8,0,13,3,0,24
LGA58760,1405,119,155,2732,133,94,417,60,53,757,25,27,99,7,15,173,24,19,56,11,11,121,44,12,50,4,12,122,1953,509,2873,263,353,5951
LGA58820,6,0,0,9,0,0,0,0,0,0,0,0,0,0,0,0,3,0,0,0,0,3,0,0,3,0,0,3,67,5,65,0,3,140
LGA58890,0,0,0,0,0,0,0,0,0,0,0,0,0,0,0,0,0,0,0,0,0,0,0,0,3,0,0,3,17,0,29,3,0,49
LGA59030,0,0,0,0,0,0,0,0,0,0,0,0,0,0,0,0,0,0,0,0,0,0,3,0,0,0,0,3,12,0,3,0,0,15
LGA59100,0,0,0,0,0,0,0,0,0,0,0,0,0,0,0,0,0,0,0,0,0,0,0,0,4,0,0,4,16,0,11,4,0,31
LGA59170,0,0,0,0,0,0,0,0,0,0,0,0,0,0,0,0,0,0,0,0,0,0,3,0,0,0,0,3,31,0,23,0,0,54
LGA59250,0,0,0,0,0,0,0,0,0,0,0,0,0,0,0,0,0,0,0,0,0,0,0,0,4,0,0,4,18,0,24,0,3,45
LGA59310,0,0,0,0,0,0,0,0,0,0,0,0,0,0,0,0,3,0,0,0,0,3,5,0,0,0,0,5,34,9,29,0,6,78
LGA59320,0,0,0,0,0,0,0,0,0,0,0,0,0,0,0,0,0,0,0,0,0,0,0,0,0,0,0,0,4,0,13,0,0,17
LGA59330,0,0,0,0,0,0,0,0,0,0,0,0,0,0,0,0,0,0,0,0,0,0,3,0,0,0,0,3,12,0,8,3,0,23
LGA59340,16,0,0,27,19,4,13,3,3,42,16,0,12,0,5,33,32,0,17,0,0,49,27,0,32,0,0,59,340,19,351,10,18,738
LGA59350,0,0,0,0,0,0,0,0,0,0,0,0,0,0,0,0,0,0,0,0,0,0,0,0,0,0,0,0,7,3,5,0,0,15
LGA59360,0,0,0,0,0,0,0,0,0,0,0,0,0,0,0,0,0,0,0,0,0,0,3,0,3,0,0,6,28,0,46,3,3,80
LGA59370,11,0,3,14,0,0,0,0,0,0,0,0,0,0,0,0,0,0,0,0,3,3,4,0,3,0,0,7,44,5,53,6,6,114
LGA59399,0,0,0,0,0,0,0,0,0,0,0,0,0,0,0,0,0,0,0,0,0,0,0,0,0,0,0,0,0,0,0,0,0,0
LGA60210,0,0,0,4,0,0,0,0,0,0,0,0,0,0,0,0,0,0,0,0,0,0,0,0,6,0,0,6,90,17,75,8,7,197
LGA60410,20,0,3,36,3,0,0,3,3,9,0,0,0,0,0,0,0,0,0,0,0,0,5,3,7,0,0,15,199,48,271,22,48,588
LGA60610,5,3,0,12,4,0,0,0,0,4,0,0,0,0,0,0,0,0,4,0,0,4,7,0,3,0,0,10,333,33,331,28,46,771
LGA60810,5,3,3,15,0,0,0,0,3,3,0,0,0,0,0,0,4,0,0,0,0,4,6,3,8,3,5,25,262,30,267,22,49,630
LGA61010,0,0,0,0,0,0,0,0,0,0,0,0,0,0,0,0,0,0,0,0,0,0,5,0,9,0,3,17,46,7,47,0,9,109
LGA61210,0,0,0,4,0,0,0,0,0,0,0,0,0,0,0,0,0,0,0,3,0,3,10,0,13,0,0,23,130,22,160,3,7,322
LGA61410,114,21,15,261,16,4,38,7,3,68,6,0,3,0,0,9,3,3,9,0,0,15,21,3,15,0,4,43,693,87,626,71,93,1570
LGA61510,5,0,0,5,0,0,3,0,0,3,0,0,0,0,0,0,3,0,0,0,0,3,3,3,0,0,0,6,102,23,139,13,20,297
LGA61610,3,0,4,25,0,0,0,0,3,3,0,0,0,0,0,0,0,0,0,0,0,0,12,0,12,0,0,24,449,73,408,33,62,1025
LGA61810,0,0,3,3,0,0,0,0,0,0,0,0,0,0,0,0,0,0,0,0,3,3,7,0,3,3,0,13,115,14,101,7,11,248
LGA62010,0,0,0,0,0,0,0,0,0,0,0,0,0,0,0,0,0,0,0,0,0,0,0,0,0,0,0,0,18,0,20,0,6,44
LGA62210,5,0,0,5,0,0,0,0,0,0,0,0,0,0,0,0,0,0,0,0,0,0,3,3,0,0,0,6,106,13,128,9,16,272
LGA62410,0,0,0,3,0,0,0,0,0,0,0,0,0,0,0,0,0,0,0,0,0,0,4,0,3,0,0,7,88,7,67,6,7,175
LGA62610,65,9,7,141,3,4,3,0,0,10,0,3,0,0,0,3,10,3,0,0,0,13,24,3,10,0,9,46,784,128,702,72,102,1788
LGA62810,171,13,18,479,90,13,56,12,0,171,24,5,20,4,4,57,26,0,20,0,0,46,23,3,5,4,4,39,1317,77,585,61,45,2085
LGA63010,6,0,3,13,0,0,0,0,0,0,0,0,3,0,0,3,3,0,0,0,0,3,10,3,3,0,0,16,165,34,191,16,19,425
LGA63210,0,0,0,3,0,0,0,0,0,0,0,0,0,0,0,0,0,0,0,0,0,0,4,0,0,3,0,7,71,9,57,6,7,150
LGA63410,0,0,3,3,0,0,0,0,0,0,0,0,0,0,0,0,0,0,0,0,0,0,7,0,5,0,0,12,43,3,39,3,3,91
LGA63610,131,17,5,261,11,6,32,4,3,56,0,0,3,0,0,3,3,0,4,0,0,7,8,0,11,0,0,19,457,71,493,47,32,1100
LGA63810,3,3,0,13,0,0,0,0,0,0,0,0,0,0,0,0,0,0,0,0,0,0,3,0,3,0,0,6,194,19,151,13,13,390
LGA64010,71,13,4,151,11,4,14,0,0,29,0,0,8,0,0,8,7,0,5,0,4,16,23,0,15,0,3,41,1232,147,995,96,129,2599
LGA64210,13,4,4,27,3,0,0,3,3,9,0,0,0,0,0,0,3,0,0,0,0,3,13,0,6,0,0,19,262,30,211,28,44,575
LGA64610,6,3,0,9,0,0,0,0,0,0,0,0,0,0,0,0,0,0,0,0,0,0,20,0,7,0,4,31,210,19,183,22,24,458
LGA64810,21,0,3,39,0,0,3,0,0,3,0,0,0,0,0,0,0,0,0,0,0,0,6,0,4,0,0,10,184,20,174,13,23,414
LGA65010,0,0,0,0,0,0,0,0,0,0,0,0,0,0,0,0,0,0,0,0,0,0,3,0,3,0,6,12,61,12,65,3,17,158
LGA65210,0,0,0,0,0,0,0,0,0,0,0,0,0,0,0,0,0,0,0,0,0,0,0,0,0,0,0,0,30,6,33,0,0,69
LGA65410,6,4,0,10,0,0,0,0,0,0,0,0,0,0,0,0,0,0,4,0,0,4,8,0,3,3,0,14,207,29,191,20,20,467
LGA65610,0,0,0,0,0,0,0,0,0,0,0,0,0,0,0,0,0,0,0,0,0,0,3,0,7,0,0,10,94,9,96,4,4,207
LGA65810,34,3,4,53,3,0,7,0,0,10,0,0,3,0,0,3,3,0,0,3,0,6,5,3,7,0,3,18,236,41,268,25,34,604
LGA69399,0,0,0,0,0,0,0,0,0,0,0,0,0,0,0,0,0,0,0,0,0,0,0,0,0,0,0,0,0,0,0,0,0,0
LGA70200,108,9,13,323,119,9,118,12,17,275,32,5,46,3,6,92,20,3,26,0,4,53,58,6,66,3,4,137,772,66,677,42,73,1630
LGA70420,12,0,0,20,4,0,0,0,0,4,0,0,0,0,0,0,0,0,0,0,0,0,42,4,56,0,0,102,255,42,398,4,44,743
LGA70540,0,0,0,0,0,0,0,0,0,0,0,0,0,0,0,0,0,0,0,0,0,0,0,0,0,0,0,0,0,6,8,0,3,17
LGA70620,0,0,0,0,0,0,0,0,0,0,0,0,0,0,0,0,0,0,0,0,0,0,14,3,41,3,0,61,146,16,305,6,30,503
LGA70700,0,0,0,5,0,0,0,0,0,0,0,0,0,0,0,0,0,0,4,0,0,4,3,0,3,0,0,6,26,0,20,3,0,49
LGA71000,410,36,27,1178,561,45,312,29,46,993,276,22,153,18,21,490,265,26,217,28,24,560,61,8,60,11,15,155,2838,234,2053,191,217,5533
LGA71300,0,0,0,0,0,0,0,0,0,0,0,0,0,0,0,0,0,0,0,0,0,0,26,16,64,3,8,117,254,104,619,25,84,1086
LGA72200,29,0,3,81,3,3,8,0,3,17,0,0,4,0,0,4,0,0,3,0,0,3,30,0,24,5,0,59,351,40,390,22,26,829
LGA72300,22,4,0,83,45,9,40,3,10,107,12,6,25,4,4,51,9,7,9,0,0,25,11,0,10,0,0,21,253,32,203,11,28,527
LGA72330,0,0,0,0,0,0,0,0,0,0,0,0,0,0,0,0,0,0,0,0,0,0,34,10,60,0,3,107,225,27,355,5,37,649
LGA72800,192,7,13,455,237,21,193,14,29,494,90,14,136,4,10,254,28,8,42,4,6,88,33,9,50,3,0,95,945,116,1086,61,87,2295
LGA73600,4,0,0,4,0,0,0,0,0,0,0,0,0,0,0,0,0,0,0,0,0,0,6,0,25,3,3,37,193,54,458,12,38,755
LGA74050,0,0,0,4,0,0,0,0,0,0,0,0,0,0,0,0,0,0,0,0,0,0,13,0,12,0,0,25,129,29,199,4,29,390
LGA74500,0,0,0,0,4,0,3,0,0,7,0,0,0,0,0,0,0,0,0,0,0,0,14,9,59,0,3,85,188,54,503,18,39,802
LGA74560,0,0,0,0,0,0,0,0,0,0,0,0,0,0,0,0,5,0,0,0,0,5,0,0,0,0,0,0,5,0,3,0,0,8
LGA74660,5,0,0,5,4,0,0,0,0,4,0,0,0,0,0,0,0,0,0,0,0,0,15,0,35,0,7,57,235,60,489,15,47,846
LGA79399,11,0,0,19,5,0,5,0,3,13,3,0,6,0,0,9,10,0,7,0,0,17,26,8,45,4,8,91,420,68,592,38,51,1169
LGA89399,2232,210,256,6382,1735,176,1397,130,131,3569,474,94,550,80,50,1248,278,78,374,62,34,826,154,25,140,23,23,365,8444,873,6539,694,671,17221
LGA99399,5,0,0,5,0,0,3,0,3,6,3,0,0,0,0,3,0,0,3,0,0,3,7,0,18,3,0,28,110,12,119,15,17,273
