region_id,C11_75_79_N_mar_M,C11_75_79_N_mar_F,C11_75_79_T_M,C11_75_79_T_F,C11_75_79_T_P,C11_80_84_Mar_RegM_M,C11_80_84_Mar_RegM_F,C11_80_84_Mar_DFM_M,C11_80_84_Mar_DFM_F,C11_80_84_N_mar_M,C11_80_84_N_mar_F,C11_80_84_T_M,C11_80_84_T_F,C11_80_84_T_P,C11_85o_Mar_RegM_M,C11_85o_Mar_RegM_F,C11_85o_Mar_DFM_M,C11_85o_Mar_DFM_F,C11_85o_N_mar_M,C11_85o_N_mar_F,C11_85o_T_M,C11_85o_T_F,C11_85o_T_P,C11_T_Marr_reg_marr_M,C11_T_Marr_reg_marr_F,C11_T_Mar_de_fa_mar_M,C11_T_Mar_de_fa_mar_F,C11_Tot_N_mar_M,C11_Tot_N_mar_F,C11_Tot_T_M,C11_Tot_T_F,C11_Tot_T_P
LGA10050,123,349,495,650,1145,282,159,4,3,126,354,412,516,928,129,73,3,0,81,363,213,436,649,7901,8080,1648,1711,6618,8170,16167,17961,34128
LGA10110,47,189,229,300,529,106,66,0,0,60,179,166,245,411,67,40,0,0,38,158,105,198,303,3611,3678,812,843,3048,3941,7471,8462,15933
LGA10150,121,298,466,513,979,222,130,0,5,125,269,347,404,751,128,48,6,0,102,293,236,341,577,6956,7014,1386,1372,6522,7668,14864,16054,30918
LGA10200,123,268,504,495,999,204,125,0,0,115,324,319,449,768,115,53,0,0,110,340,225,393,618,13631,13725,1032,970,12275,11506,26938,26201,53139
LGA10250,135,397,597,761,1358,360,256,9,4,161,449,530,709,1239,240,109,8,5,160,452,408,566,974,7227,7345,1363,1426,5123,6591,13713,15362,29075
LGA10300,12,16,34,26,60,11,6,0,0,6,14,17,20,37,4,0,0,0,4,15,8,15,23,410,416,85,88,275,280,770,784,1554
LGA10350,480,1281,1893,2362,4255,1097,651,8,8,481,1489,1586,2148,3734,607,281,9,3,480,1447,1096,1731,2827,34111,34292,2335,2378,27547,31326,63993,67996,131989
LGA10470,100,247,364,499,863,194,110,6,0,87,263,287,373,660,82,38,0,0,58,256,140,294,434,6248,6356,1390,1431,4945,5670,12583,13457,26040
LGA10550,137,260,529,545,1074,232,156,4,3,109,260,345,419,764,136,53,0,3,102,257,238,313,551,5934,6022,1346,1404,3968,4535,11248,11961,23209
LGA10600,55,103,218,225,443,86,45,6,3,40,109,132,157,289,64,29,0,3,36,101,100,133,233,2106,2138,562,609,1647,2058,4315,4805,9120
LGA10650,39,70,158,142,300,86,51,3,0,30,74,119,125,244,48,24,0,0,28,70,76,94,170,1566,1582,253,254,1054,1078,2873,2914,5787
LGA10750,551,1563,1969,2451,4420,790,448,7,3,456,1201,1253,1652,2905,352,156,10,3,258,1039,620,1198,1818,55728,56183,6484,6689,42587,47666,104799,110538,215337
LGA10800,20,46,96,103,199,55,25,0,0,19,60,74,85,159,22,13,0,0,18,51,40,64,104,1145,1158,187,195,731,694,2063,2047,4110
LGA10850,34,49,104,100,204,50,26,0,3,25,55,75,84,159,16,5,0,0,10,31,26,36,62,1292,1313,197,214,891,937,2380,2464,4844
LGA10900,195,593,804,1012,1816,353,215,11,3,170,513,534,731,1265,188,92,4,3,161,587,353,682,1035,13916,14148,2517,2709,9463,11998,25896,28855,54751
LGA10950,17,19,47,40,87,13,10,0,0,8,22,21,32,53,5,0,0,0,6,13,11,13,24,470,485,89,100,380,363,939,948,1887
LGA11000,12,24,35,38,73,11,14,0,0,12,19,23,33,56,14,8,0,0,13,24,27,32,59,455,449,93,89,353,313,901,851,1752
LGA11050,6,24,30,43,73,21,13,0,0,9,24,30,37,67,5,0,0,0,3,25,8,25,33,459,456,67,68,333,345,859,869,1728
LGA11100,124,307,444,523,967,216,112,3,0,104,317,323,429,752,91,40,0,0,88,296,179,336,515,6983,7062,1093,1033,6231,7120,14307,15215,29522
LGA11150,15,15,31,26,57,9,8,0,0,5,16,14,24,38,3,0,0,0,0,12,3,12,15,345,349,132,133,354,386,831,868,1699
LGA11200,9,7,13,12,25,4,3,0,0,5,14,9,17,26,4,3,0,0,3,6,7,9,16,147,142,112,120,286,310,545,572,1117
LGA11250,82,211,284,363,647,146,88,5,0,78,210,229,298,527,59,28,0,0,54,156,113,184,297,2881,2945,692,727,2683,3135,6256,6807,13063
LGA11300,77,254,338,430,768,216,117,0,0,75,269,291,386,677,115,46,0,0,80,257,195,303,498,5785,5861,563,560,5686,6468,12034,12889,24923
LGA11350,72,158,248,318,566,128,83,3,0,73,182,204,265,469,79,32,3,0,69,195,151,227,378,3971,4090,1426,1446,4485,5263,9882,10799,20681
LGA11400,64,102,207,201,408,79,51,3,0,41,70,123,121,244,28,21,0,0,28,84,56,105,161,2622,2655,392,405,1507,1524,4521,4584,9105
LGA11450,75,238,401,442,843,168,95,0,0,76,238,244,333,577,92,53,3,0,60,244,155,297,452,11245,11371,1575,1631,6551,7595,19371,20597,39968
LGA11500,253,701,904,1109,2013,357,228,15,14,179,581,551,823,1374,171,80,9,0,137,473,317,553,870,25170,25417,3911,4025,21673,25300,50754,54742,105496
LGA11520,166,496,793,976,1769,481,245,6,4,162,583,649,832,1481,251,98,3,4,144,603,398,705,1103,14586,14781,2428,2471,10254,12702,27268,29954,57222
LGA11550,399,936,1690,1785,3475,839,453,7,5,326,899,1172,1357,2529,447,186,0,0,250,877,697,1063,1760,26355,26496,2121,2132,21750,22904,50226,51532,101758
LGA11600,7,18,30,31,61,16,9,0,0,11,13,27,22,49,5,3,0,0,3,10,8,13,21,474,470,93,101,384,266,951,837,1788
LGA11700,7,13,12,16,28,3,0,0,0,4,12,7,12,19,0,3,0,0,4,7,4,10,14,237,230,106,107,365,298,708,635,1343
LGA11720,141,346,517,611,1128,210,139,6,5,130,347,346,491,837,97,35,6,0,99,305,202,340,542,8479,8615,1992,2053,6881,7785,17352,18453,35805
LGA11730,246,430,860,893,1753,388,235,16,5,183,428,587,668,1255,185,78,8,3,134,432,327,513,840,8914,9013,1740,1825,6699,7619,17353,18457,35810
LGA11750,9,25,38,48,86,19,6,0,0,8,25,27,31,58,0,0,0,0,8,23,8,23,31,693,708,250,248,668,532,1611,1488,3099
LGA11800,207,513,953,1081,2034,494,288,7,10,197,470,698,768,1466,253,123,3,3,206,561,462,687,1149,11947,12175,2424,2511,9163,11109,23534,25795,49329
LGA11860,0,8,10,11,21,4,5,0,0,4,3,8,8,16,4,0,0,0,3,3,7,3,10,330,325,55,56,192,117,577,498,1075
LGA12000,18,38,64,75,139,39,22,0,0,16,23,55,45,100,18,8,0,0,5,36,23,44,67,815,825,96,102,457,520,1368,1447,2815
LGA12050,37,76,151,134,285,46,29,0,0,34,96,80,125,205,44,19,0,0,27,88,71,107,178,1742,1768,354,358,1281,1400,3377,3526,6903
LGA12150,17,26,62,61,123,26,12,0,0,14,34,40,46,86,8,5,0,0,6,29,14,34,48,611,613,172,168,618,610,1401,1391,2792
LGA12200,26,45,128,129,257,68,48,0,0,23,96,91,144,235,23,7,0,0,18,81,41,88,129,1439,1467,196,203,860,1081,2495,2751,5246
LGA12300,67,87,232,231,463,117,66,4,0,51,95,172,161,333,55,18,0,3,40,106,95,127,222,2204,2239,367,375,1420,1409,3991,4023,8014
LGA12350,54,100,186,217,403,95,55,4,3,52,118,151,176,327,45,29,0,0,37,115,82,144,226,2232,2256,400,417,1671,1749,4303,4422,8725
LGA12500,25,82,118,148,266,64,42,3,0,38,66,105,108,213,24,5,0,0,34,90,58,95,153,1200,1215,253,254,984,1191,2437,2660,5097
LGA12600,111,278,380,493,873,200,119,9,0,103,235,312,354,666,102,47,0,0,69,243,171,290,461,6237,6507,1400,1501,4753,6157,12390,14165,26555
LGA12700,33,43,121,97,218,35,20,3,0,28,60,66,80,146,23,12,0,0,23,67,46,79,125,1675,1707,277,288,1099,1072,3051,3067,6118
LGA12750,186,331,728,728,1456,351,212,13,6,170,341,534,559,1093,167,100,0,3,133,332,300,435,735,6741,6820,1277,1322,4563,5204,12581,13346,25927
LGA12850,437,1255,1899,2201,4100,914,434,6,4,378,1153,1298,1591,2889,417,156,4,4,305,929,726,1089,1815,34521,34704,2265,2275,31812,35482,68598,72461,141059
LGA12900,41,92,143,171,314,52,36,0,0,35,90,87,126,213,29,12,0,0,22,74,51,86,137,1645,1666,280,289,1214,1314,3139,3269,6408
LGA12950,16,38,63,70,133,36,20,0,0,22,36,58,56,114,15,7,0,0,10,34,25,41,66,790,822,120,129,521,622,1431,1573,3004
LGA13010,43,79,143,154,297,65,36,0,3,30,101,95,140,235,30,17,0,0,20,75,50,92,142,1527,1540,315,317,1147,1307,2989,3164,6153
LGA13050,22,56,81,115,196,60,26,0,0,14,67,74,93,167,25,12,0,0,20,39,45,51,96,997,1005,156,165,629,665,1782,1835,3617
LGA13100,568,1571,2218,2873,5091,1235,859,32,19,584,1671,1851,2549,4400,771,435,18,7,593,1812,1382,2254,3636,29140,29563,5135,5293,22028,27795,56303,62651,118954
LGA13310,108,232,337,414,751,169,101,0,3,78,229,247,333,580,78,45,0,0,58,199,136,244,380,4644,4725,1004,1017,3721,4290,9369,10032,19401
LGA13320,236,358,874,896,1770,466,287,13,9,211,382,690,678,1368,216,122,8,3,153,401,377,526,903,6673,6779,1117,1148,4502,5332,12292,13259,25551
LGA13340,30,66,104,130,234,60,38,0,0,38,67,98,105,203,37,9,0,0,29,63,66,72,138,1968,1998,256,254,1247,1202,3471,3454,6925
LGA13380,221,434,846,857,1703,402,248,11,6,180,410,593,664,1257,203,79,0,0,151,421,354,500,854,8518,8622,1567,1589,6045,7355,16130,17566,33696
LGA13450,74,164,291,331,622,162,84,0,3,61,173,223,260,483,89,35,0,0,39,164,128,199,327,4539,4590,661,670,3133,3290,8333,8550,16883
LGA13500,16,29,50,55,105,20,13,0,0,10,30,30,43,73,17,9,0,0,8,31,25,40,65,680,696,152,161,492,438,1324,1295,2619
LGA13550,52,105,187,196,383,72,48,0,3,39,103,111,154,265,31,10,0,0,28,104,59,114,173,2119,2148,415,423,1608,1737,4142,4308,8450
LGA13650,15,33,51,68,119,29,9,0,3,18,44,47,56,103,13,4,0,0,11,28,24,32,56,763,770,174,178,581,576,1518,1524,3042
LGA13660,30,37,102,80,182,24,15,0,3,16,52,40,70,110,12,7,0,0,16,48,28,55,83,981,993,188,195,638,619,1807,1807,3614
LGA13700,17,31,51,72,123,26,12,0,0,18,32,44,44,88,16,7,0,0,10,29,26,36,62,700,714,113,119,444,493,1257,1326,2583
LGA13800,115,310,473,559,1032,212,147,8,3,120,292,340,442,782,114,61,5,4,98,308,217,373,590,11194,11400,2017,2080,8415,9213,21626,22693,44319
LGA13850,23,27,63,51,114,16,6,0,0,13,25,29,31,60,7,0,0,0,10,19,17,19,36,509,525,102,102,402,416,1013,1043,2056
LGA13950,246,641,899,1066,1965,412,235,8,3,224,659,644,897,1541,209,91,3,3,174,610,386,704,1090,19186,19266,1569,1604,14756,16209,35511,37079,72590
LGA14000,267,908,1562,1868,3430,923,624,10,4,308,981,1241,1609,2850,541,245,5,4,358,1179,904,1428,2332,33851,34433,2654,2693,20092,23706,56597,60832,117429
LGA14100,33,91,149,174,323,97,67,0,0,29,116,126,183,309,64,25,0,4,46,157,110,186,296,2499,2528,298,283,1440,2010,4237,4821,9058
LGA14150,211,591,992,1169,2161,501,331,8,3,188,659,697,993,1690,336,136,4,4,217,778,557,918,1475,15940,16124,1503,1496,11674,14068,29117,31688,60805
LGA14200,69,141,241,265,506,123,49,3,3,37,146,163,198,361,43,19,0,0,39,159,82,178,260,2887,2936,529,536,2041,2357,5457,5829,11286
LGA14250,0,9,14,15,29,12,18,0,0,12,6,24,24,48,12,4,0,0,0,12,12,16,28,301,292,40,37,188,154,529,483,1012
LGA14300,18,37,59,68,127,20,6,0,0,19,40,39,46,85,12,6,0,0,9,40,21,46,67,937,946,159,170,655,691,1751,1807,3558
LGA14350,126,226,440,404,844,174,128,4,0,121,214,299,342,641,104,44,0,0,91,232,195,276,471,4561,4616,962,1001,4028,4460,9551,10077,19628
LGA14400,58,166,318,369,687,182,101,5,3,55,184,242,288,530,90,56,0,0,79,221,169,277,446,4264,4352,512,540,2387,2825,7163,7717,14880
LGA14450,108,334,634,703,1337,341,198,4,0,117,410,462,608,1070,221,113,0,0,142,474,363,587,950,11445,11552,1113,1089,8152,9683,20710,22324,43034
LGA14500,198,703,1454,1613,3067,884,647,15,0,237,862,1136,1509,2645,638,326,5,0,294,1107,937,1433,2370,24253,24867,1353,1323,11988,15926,37594,42116,79710
LGA14550,37,69,133,150,283,57,28,0,3,24,79,81,110,191,32,10,0,0,28,72,60,82,142,1559,1593,386,397,1373,1367,3318,3357,6675
LGA14600,43,45,116,94,210,46,39,0,3,26,36,72,78,150,28,14,0,0,18,57,46,71,117,1167,1169,246,252,893,862,2306,2283,4589
LGA14650,641,1578,2717,3161,5878,1413,956,20,16,617,1612,2050,2584,4634,797,402,10,7,555,1594,1362,2003,3365,36029,36717,5882,6107,25686,30120,67597,72944,140541
LGA14700,60,198,264,363,627,139,94,0,0,61,212,200,306,506,104,53,6,0,66,274,176,327,503,6071,6175,971,921,4024,5165,11066,12261,23327
LGA14750,33,86,132,166,298,47,16,0,0,22,88,69,104,173,16,8,0,0,30,64,46,72,118,1828,1854,335,348,1335,1491,3498,3693,7191
LGA14800,106,293,337,443,780,131,72,3,3,106,244,240,319,559,66,26,3,3,64,242,133,271,404,7951,8105,3128,3151,6639,9492,17718,20748,38466
LGA14850,126,295,466,552,1018,249,160,0,3,102,321,351,484,835,119,52,3,0,96,322,218,374,592,6712,6785,1703,1779,6325,7487,14740,16051,30791
LGA14870,96,166,290,281,571,112,80,3,0,68,154,183,234,417,43,17,3,0,29,161,75,178,253,3421,3454,717,718,2944,3109,7082,7281,14363
LGA14900,322,928,1230,1476,2706,522,259,3,8,240,760,765,1027,1792,213,78,6,3,186,571,405,652,1057,33593,33894,3077,3150,25271,27952,61941,64996,126937
LGA14920,44,59,135,127,262,47,32,4,3,24,61,75,96,171,26,9,0,0,35,55,61,64,125,1368,1373,263,282,1043,1041,2674,2696,5370
LGA14950,12,16,54,34,88,32,18,0,0,16,21,48,39,87,9,3,0,0,12,28,21,31,52,636,620,64,64,394,329,1094,1013,2107
LGA15050,141,402,647,792,1439,295,171,7,7,113,461,415,639,1054,152,87,7,0,110,425,269,512,781,12369,12663,2396,2484,8510,10084,23275,25231,48506
LGA15150,79,225,358,433,791,227,162,10,3,65,268,302,433,735,156,68,0,0,113,352,269,420,689,6995,7130,1873,1867,4933,5962,13801,14959,28760
LGA15200,211,411,655,758,1413,277,141,4,0,146,344,427,485,912,135,50,0,0,102,313,237,363,600,10157,10216,4515,4560,12990,14895,27662,29671,57333
LGA15270,89,161,312,330,642,126,77,0,0,68,162,194,239,433,56,20,0,0,61,148,117,168,285,3953,4023,863,882,2905,2958,7721,7863,15584
LGA15300,44,73,127,114,241,33,26,0,0,23,66,56,92,148,15,4,0,0,22,67,37,71,108,1960,1967,574,598,1823,1776,4357,4341,8698
LGA15350,56,201,248,340,588,166,105,0,0,62,220,228,325,553,124,61,0,0,75,326,199,387,586,5015,5176,877,857,2991,4710,8883,10743,19626
LGA15500,31,67,132,137,269,61,34,4,0,32,59,97,93,190,25,16,0,0,21,43,46,59,105,1391,1418,237,245,834,853,2462,2516,4978
LGA15550,12,7,36,27,63,10,6,3,0,7,12,20,18,38,5,4,0,0,0,5,5,9,14,396,391,85,86,328,256,809,733,1542
LGA15650,47,93,124,162,286,47,30,0,0,33,77,80,107,187,23,6,3,0,19,68,45,74,119,2529,2556,664,682,2138,1986,5331,5224,10555
LGA15700,115,194,358,383,741,154,126,11,5,82,205,247,336,583,132,62,9,5,87,196,228,263,491,3231,3265,682,725,2711,3127,6624,7117,13741
LGA15750,56,104,161,185,346,60,45,0,3,33,87,93,135,228,47,17,0,3,21,67,68,87,155,2315,2336,459,468,1659,1675,4433,4479,8912
LGA15800,33,50,101,94,195,44,26,0,0,26,64,70,90,160,13,13,0,0,20,54,33,67,100,1018,1031,159,162,818,866,1995,2059,4054
LGA15850,34,60,88,91,179,37,23,0,0,15,42,52,65,117,15,8,0,0,9,36,24,44,68,1110,1132,205,202,851,934,2166,2268,4434
LGA15900,431,1206,1571,2125,3696,804,634,13,10,474,1347,1291,1991,3282,532,247,5,0,424,1397,961,1644,2605,23349,23732,5710,5919,24225,27102,53284,56753,110037
LGA15950,123,393,463,614,1077,180,122,9,3,128,374,317,499,816,141,61,3,3,119,465,263,529,792,9581,9711,3697,3534,9081,12346,22359,25591,47950
LGA16100,20,31,65,59,124,28,14,0,0,19,29,47,43,90,9,4,3,0,12,31,24,35,59,946,959,183,188,657,582,1786,1729,3515
LGA16150,106,278,423,523,946,174,112,8,0,66,290,248,402,650,96,54,3,3,84,288,183,345,528,6133,6280,1305,1350,4885,6037,12323,13667,25990
LGA16180,40,43,118,90,208,45,25,0,0,21,43,66,68,134,14,3,0,0,17,41,31,44,75,2874,2882,570,560,1499,1537,4943,4979,9922
LGA16200,72,122,208,236,444,105,63,0,3,61,122,166,188,354,57,31,0,0,30,124,87,155,242,2452,2497,476,490,1876,2119,4804,5106,9910
LGA16250,388,923,1491,1701,3192,748,433,10,6,294,1004,1052,1443,2495,375,189,5,5,327,1146,707,1340,2047,31650,31796,2990,3044,25770,27212,60410,62052,122462
LGA16350,333,867,1212,1438,2650,476,275,7,5,274,767,757,1047,1804,250,124,5,6,215,746,470,876,1346,31737,32098,5670,5853,25473,28691,62880,66642,129522
LGA16370,115,361,606,753,1359,358,230,10,8,140,402,508,640,1148,227,102,4,4,163,497,394,603,997,11547,11754,1677,1726,6662,7875,19886,21355,41241
LGA16380,312,742,1470,1662,3132,789,504,23,11,267,795,1079,1310,2389,404,196,9,3,306,857,719,1056,1775,14078,14334,2402,2455,8838,11541,25318,28330,53648
LGA16400,213,506,941,1048,1989,450,291,17,0,173,469,640,760,1400,229,110,3,3,161,475,393,588,981,12073,12317,2218,2263,8147,9463,22438,24043,46481
LGA16470,76,186,262,306,568,127,69,0,0,55,179,182,248,430,37,14,0,0,53,207,90,221,311,6464,6604,1513,1513,5605,5800,13582,13917,27499
LGA16550,313,862,1199,1481,2680,658,411,0,3,314,962,972,1376,2348,399,155,4,3,326,997,729,1155,1884,19222,19445,4949,5006,20594,24669,44765,49120,93885
LGA16610,105,207,363,402,765,174,92,6,3,77,202,257,297,554,67,35,3,0,75,230,145,265,410,3763,3821,820,843,3098,3473,7681,8137,15818
LGA16650,268,717,1189,1378,2567,633,329,3,3,260,686,896,1018,1914,349,167,4,3,263,906,616,1076,1692,18470,18608,2258,2185,15184,16833,35912,37626,73538
LGA16700,269,744,1143,1383,2526,635,398,3,0,258,885,896,1283,2179,353,171,0,0,275,913,628,1084,1712,19873,20072,2314,2326,15264,18690,37451,41088,78539
LGA16900,160,456,712,841,1553,349,197,9,6,157,438,515,641,1156,147,77,3,3,96,326,246,406,652,12014,12203,1903,1976,8516,9926,22433,24105,46538
LGA16950,448,885,1763,1887,3650,874,597,25,10,362,855,1261,1462,2723,448,185,10,3,327,801,785,989,1774,17107,17403,2989,3116,12022,14049,32118,34568,66686
LGA17000,48,86,184,188,372,76,55,0,4,31,112,107,171,278,37,17,0,0,24,81,61,98,159,4138,4232,871,897,3002,2694,8011,7823,15834
LGA17050,18,31,68,65,133,30,17,0,3,16,19,46,39,85,6,3,0,0,12,25,18,28,46,1118,1128,281,292,881,746,2280,2166,4446
LGA17100,85,227,331,394,725,174,86,0,0,58,204,232,290,522,82,42,3,5,77,253,162,300,462,6725,6784,535,538,5873,6034,13133,13356,26489
LGA17150,487,1363,2290,2806,5096,1398,936,22,9,482,1695,1902,2640,4542,740,357,7,5,508,1700,1255,2062,3317,42820,43475,5658,5765,27765,32869,76243,82109,158352
LGA17200,500,653,955,976,1931,306,155,9,3,314,571,629,729,1358,160,50,3,0,192,553,355,603,958,15616,15719,13879,10044,36885,34852,66380,60615,126995
LGA17310,172,424,743,809,1552,343,198,5,0,133,461,481,659,1140,161,69,3,3,117,466,281,538,819,9789,10037,1858,1954,7021,8791,18668,20782,39450
LGA17350,34,62,109,118,227,46,24,0,0,21,81,67,105,172,19,9,0,0,18,76,37,85,122,1121,1141,146,149,766,821,2033,2111,4144
LGA17400,30,59,117,102,219,36,27,0,0,15,65,51,92,143,17,7,0,0,18,50,35,57,92,1197,1207,211,225,912,973,2320,2405,4725
LGA17420,238,700,1399,1465,2864,665,342,0,6,210,700,875,1048,1923,314,139,6,3,190,701,510,843,1353,38253,38946,2639,2704,20279,23157,61171,64807,125978
LGA17450,21,27,54,57,111,10,11,0,0,12,23,22,34,56,15,3,0,0,13,27,28,30,58,628,636,123,130,429,362,1180,1128,2308
LGA17500,38,76,160,146,306,67,42,3,3,46,90,116,135,251,39,16,3,3,20,90,62,109,171,1945,1969,467,477,1477,1426,3889,3872,7761
LGA17550,424,932,1609,1924,3533,919,560,28,17,358,870,1305,1447,2752,471,240,11,5,362,930,844,1175,2019,14926,15265,2997,3156,11815,14538,29738,32959,62697
LGA17620,32,103,166,198,364,80,50,3,0,42,95,125,145,270,43,17,3,0,29,103,75,120,195,2480,2516,564,574,1773,1791,4817,4881,9698
LGA17640,39,71,133,134,267,49,28,4,3,29,45,82,76,158,18,8,3,0,24,50,45,58,103,1497,1502,186,204,935,911,2618,2617,5235
LGA17650,16,39,74,82,156,24,25,0,0,17,33,41,58,99,15,6,0,0,8,25,23,31,54,1183,1195,177,189,719,778,2079,2162,4241
LGA17700,9,8,23,24,47,10,0,0,0,0,13,10,13,23,3,0,0,0,8,6,11,6,17,229,225,38,38,165,115,432,378,810
LGA17750,133,387,563,723,1286,271,174,4,3,137,396,412,573,985,168,82,0,0,115,395,283,477,760,9907,10109,2049,2165,7715,9336,19671,21610,41281
LGA17800,17,36,68,63,131,29,31,3,0,22,40,54,71,125,20,8,0,0,19,20,39,28,67,805,813,124,131,502,417,1431,1361,2792
LGA17850,7,33,42,51,93,19,9,0,0,15,29,34,38,72,7,7,0,0,7,26,14,33,47,640,640,88,92,368,372,1096,1104,2200
LGA17900,44,31,81,45,126,23,15,0,0,41,30,64,45,109,7,3,3,3,14,16,24,22,46,789,783,317,309,1252,874,2358,1966,4324
LGA17950,8,29,33,48,81,13,6,0,0,8,19,21,25,46,3,0,0,0,8,16,11,16,27,502,500,102,99,402,339,1006,938,1944
LGA18000,329,964,1528,1878,3406,866,583,11,5,323,1139,1200,1727,2927,541,267,9,3,443,1406,993,1676,2669,27476,27880,4472,4597,18100,21076,50048,53553,103601
LGA18020,63,88,165,186,351,82,46,0,0,34,80,116,126,242,40,20,3,0,21,85,64,105,169,1705,1718,313,325,1241,1284,3259,3327,6586
LGA18050,152,394,499,649,1148,272,177,14,3,120,402,406,582,988,194,86,4,5,159,576,357,667,1024,8752,8871,3513,3360,9609,11414,21874,23645,45519
LGA18100,26,31,70,68,138,38,20,3,0,23,39,64,59,123,19,12,0,0,9,37,28,49,77,741,746,111,111,511,474,1363,1331,2694
LGA18150,42,80,124,141,265,57,32,0,0,35,59,92,91,183,18,4,0,0,25,55,43,59,102,1287,1328,292,304,1132,1227,2711,2859,5570
LGA18200,23,33,77,86,163,39,20,0,0,28,24,67,44,111,10,10,0,0,16,38,26,48,74,1233,1262,237,247,875,798,2345,2307,4652
LGA18250,129,356,627,725,1352,386,215,6,0,129,430,521,645,1166,225,109,0,0,159,583,384,692,1076,13153,13382,1791,1715,8623,11337,23567,26434,50001
LGA18350,144,405,754,807,1561,365,208,7,0,116,367,488,575,1063,188,99,3,0,116,393,307,492,799,8635,8792,1322,1340,5099,6685,15056,16817,31873
LGA18400,79,195,353,381,734,144,80,5,0,63,182,212,262,474,78,43,3,0,48,187,129,230,359,8534,8665,1323,1371,5290,5658,15147,15694,30841
LGA18450,609,1541,2590,3050,5640,1301,840,13,16,541,1564,1855,2420,4275,698,315,14,9,498,1511,1210,1835,3045,34677,35157,5612,5786,29502,32151,69791,73094,142885
LGA18500,115,369,510,623,1133,298,181,11,8,124,437,433,626,1059,250,114,13,0,171,654,434,768,1202,8054,8180,2436,2102,6594,9849,17084,20131,37215
LGA18550,586,1393,2181,2626,4807,1079,702,22,19,569,1336,1670,2057,3727,584,280,6,7,482,1357,1072,1644,2716,25441,25808,5136,5330,21013,26031,51590,57169,108759
LGA18710,29,63,142,137,279,76,37,5,0,31,72,112,109,221,25,20,0,0,29,61,54,81,135,2993,3049,547,594,1583,1674,5123,5317,10440
LGA18750,57,114,161,191,352,64,40,0,0,45,123,109,163,272,35,17,0,0,32,121,67,138,205,2118,2154,408,412,1530,1811,4056,4377,8433
LGA19399,9,5,12,8,20,3,5,0,0,0,4,3,9,12,3,0,0,0,3,3,6,3,9,195,200,34,37,137,86,366,323,689
LGA20110,32,96,195,208,403,87,52,0,0,36,113,123,165,288,53,18,0,0,33,98,86,116,202,2292,2335,425,425,1500,1591,4217,4351,8568
LGA20260,47,106,171,198,369,82,55,3,0,44,113,129,168,297,37,24,3,0,29,86,69,110,179,2032,2054,370,377,1473,1599,3875,4030,7905
LGA20570,251,714,986,1274,2260,505,328,3,5,214,782,722,1115,1837,282,150,0,0,207,770,489,920,1409,15261,15492,3234,3337,12977,16650,31472,35479,66951
LGA20660,284,859,1315,1665,2980,744,483,9,3,269,947,1022,1433,2455,435,206,0,0,298,995,733,1201,1934,22565,22826,3326,3366,16887,20580,42778,46772,89550
LGA20740,139,268,527,553,1080,250,167,5,3,131,293,386,463,849,115,56,0,0,107,275,222,331,553,5325,5346,1099,1123,3877,4394,10301,10863,21164
LGA20830,135,305,549,601,1150,261,147,3,3,96,307,360,457,817,107,45,0,0,96,313,203,358,561,8124,8255,1449,1509,5425,6364,14998,16128,31126
LGA20910,227,640,985,1263,2248,664,435,14,5,219,830,897,1270,2167,442,253,12,3,337,1207,791,1463,2254,18019,18444,2325,2377,10889,14471,31233,35292,66525
LGA21010,41,119,205,242,447,118,80,3,4,52,145,173,229,402,70,33,0,0,51,142,121,175,296,2558,2628,455,452,1819,2160,4832,5240,10072
LGA21110,305,1009,1550,1905,3455,907,606,19,9,333,1287,1259,1902,3161,671,336,6,0,389,1594,1066,1930,2996,29734,30517,4082,3972,22376,28160,56192,62649,118841
LGA21180,332,1028,1649,1878,3527,710,434,9,3,252,914,971,1351,2322,336,141,0,0,269,816,605,957,1562,33925,34149,3439,3436,30713,31508,68077,69093,137170
LGA21270,33,71,115,129,244,67,51,0,0,34,71,101,122,223,38,13,0,0,35,85,73,98,171,1286,1297,178,177,910,864,2374,2338,4712
LGA21370,145,310,535,602,1137,251,165,0,4,107,311,358,480,838,129,63,4,0,105,304,238,367,605,6789,6897,1157,1197,4650,5227,12596,13321,25917
LGA21450,124,265,590,584,1174,258,164,5,5,117,301,380,470,850,129,54,0,3,105,264,234,321,555,13525,13668,3060,3163,8946,9995,25531,26826,52357
LGA21610,322,1043,1616,1943,3559,753,448,17,8,340,922,1110,1378,2488,350,173,5,4,263,797,618,974,1592,48375,48721,7042,7207,33840,36592,89257,92520,181777
LGA21670,81,122,261,241,502,117,71,3,0,58,142,178,213,391,50,25,0,0,51,146,101,171,272,2250,2265,408,410,1931,2144,4589,4819,9408
LGA21750,74,179,257,325,582,135,82,0,0,68,203,203,285,488,72,29,0,0,52,198,124,227,351,3544,3580,812,810,2761,3041,7117,7431,14548
LGA21830,72,147,265,283,548,103,63,0,0,69,133,172,196,368,52,28,0,0,47,129,99,157,256,3167,3192,468,474,2156,2162,5791,5828,11619
LGA21890,413,1145,1716,2087,3803,874,493,4,3,432,1204,1310,1700,3010,485,220,5,3,397,1115,887,1338,2225,21977,22130,4963,5376,22609,26106,49549,53612,103161
LGA22110,189,384,764,776,1540,334,208,7,3,151,385,492,596,1088,181,87,3,0,151,354,335,441,776,7875,7994,1586,1662,5394,6047,14855,15703,30558
LGA22170,328,848,1185,1540,2725,596,362,16,6,292,831,904,1199,2103,316,169,7,3,263,776,586,948,1534,20757,20982,5112,5191,19073,22155,44942,48328,93270
LGA22250,54,102,193,212,405,102,60,3,3,48,118,153,181,334,51,21,0,0,42,122,93,143,236,2046,2055,298,310,1347,1468,3691,3833,7524
LGA22310,319,953,1269,1760,3029,855,565,18,4,373,1141,1246,1710,2956,597,278,12,7,447,1542,1056,1827,2883,24439,24626,3721,3667,19176,22993,47336,51286,98622
LGA22410,81,135,256,268,524,102,64,3,5,78,159,183,228,411,61,27,0,0,49,134,110,161,271,3566,3623,699,720,2676,2724,6941,7067,14008
LGA22490,38,71,141,139,280,52,22,0,0,32,61,84,83,167,21,5,0,0,20,49,41,54,95,3872,3933,617,641,2149,1975,6638,6549,13187
LGA22620,294,682,1178,1334,2512,548,402,11,3,286,788,845,1193,2038,323,146,0,3,234,756,557,905,1462,17162,17496,3475,3594,13781,16950,34418,38040,72458
LGA22670,397,1012,1520,1786,3306,705,389,15,5,312,978,1032,1372,2404,381,164,6,5,251,846,638,1015,1653,25288,25375,2164,2179,24198,23806,51650,51360,103010
LGA22750,629,1618,2530,3173,5703,1496,905,12,3,579,1777,2087,2685,4772,768,414,9,8,540,1835,1317,2257,3574,37803,38261,6766,6966,28914,35821,73483,81048,154531
LGA22830,182,419,649,770,1419,330,206,4,7,138,389,472,602,1074,177,94,3,3,121,396,301,493,794,10594,10709,1887,1935,8023,9067,20504,21711,42215
LGA22910,64,114,191,209,400,88,44,0,0,54,136,142,180,322,39,18,0,0,30,107,69,125,194,2427,2437,664,684,1913,2275,5004,5396,10400
LGA22980,33,53,117,105,222,55,32,0,0,32,82,87,114,201,31,22,0,0,29,74,60,96,156,1155,1172,123,127,815,824,2093,2123,4216
LGA23110,257,682,939,1221,2160,437,256,5,0,236,638,678,894,1572,244,119,5,0,226,596,475,715,1190,15016,15199,2787,2821,13233,14071,31036,32091,63127
LGA23190,70,195,269,330,599,132,90,5,0,76,196,213,286,499,79,38,0,0,42,196,121,234,355,3599,3645,614,631,2499,2987,6712,7263,13975
LGA23270,256,793,1178,1390,2568,502,253,3,4,220,621,725,878,1603,180,70,4,0,135,449,319,519,838,31326,31566,3614,3655,24311,26462,59251,61683,120934
LGA23350,47,91,184,191,375,89,46,0,3,34,92,123,141,264,30,16,0,0,40,107,70,123,193,2916,2992,533,536,1809,1955,5258,5483,10741
LGA23430,390,1149,1709,2174,3883,908,573,10,11,359,1249,1277,1833,3110,545,264,9,4,404,1260,958,1528,2486,27204,27506,4224,4276,20511,24169,51939,55951,107890
LGA23670,286,858,1315,1606,2921,652,394,12,9,264,821,928,1224,2152,341,182,5,0,235,825,581,1007,1588,29991,30284,4060,4162,21151,24221,55202,58667,113869
LGA23810,228,502,842,951,1793,407,242,8,5,200,503,615,750,1365,195,82,0,4,155,471,350,557,907,12040,12405,2652,2790,10128,11846,24820,27041,51861
LGA23940,40,68,131,155,286,72,44,4,0,40,74,116,118,234,38,13,0,0,38,59,76,72,148,1461,1488,217,219,1112,932,2790,2639,5429
LGA24130,95,212,356,396,752,168,87,0,4,62,186,230,277,507,83,39,4,0,64,190,151,229,380,8266,8435,1443,1404,4748,5505,14457,15344,29801
LGA24210,263,859,1823,1876,3699,929,492,9,4,241,805,1179,1301,2480,432,196,5,0,229,780,666,976,1642,24994,25384,1757,1753,14898,18006,41649,45143,86792
LGA24250,33,56,98,105,203,49,24,0,0,24,54,73,78,151,15,11,0,0,17,64,32,75,107,1394,1423,280,293,929,1024,2603,2740,5343
LGA24330,187,441,531,726,1257,316,184,6,0,173,442,495,626,1121,174,78,4,0,162,458,340,536,876,10643,10707,3163,3049,12755,12852,26561,26608,53169
LGA24410,261,718,1108,1364,2472,532,351,10,0,240,790,782,1141,1923,305,157,3,0,224,737,532,894,1426,19400,19596,3233,3267,14500,17688,37133,40551,77684
LGA24600,147,231,369,374,743,140,66,8,0,108,224,256,290,546,71,38,3,3,66,213,140,254,394,8827,8921,5353,4851,20032,21866,34212,35638,69850
LGA24650,127,341,480,585,1065,174,107,4,6,99,291,277,404,681,82,50,0,0,58,232,140,282,422,20209,20398,3387,3433,13608,15058,37204,38889,76093
LGA24780,154,403,620,754,1374,338,201,4,3,143,423,485,627,1112,172,88,0,3,129,404,301,495,796,8712,8937,1658,1754,6874,7990,17244,18681,35925
LGA24850,86,183,300,345,645,136,80,4,0,65,172,205,252,457,61,27,0,0,58,127,119,154,273,6016,6130,1297,1337,4475,4743,11788,12210,23998
LGA24900,104,242,475,527,1002,246,163,0,3,107,233,353,399,752,132,54,4,3,90,240,226,297,523,5360,5417,893,917,3620,3840,9873,10174,20047
LGA24970,427,1273,2424,2709,5133,1366,790,13,8,431,1334,1810,2132,3942,642,288,3,3,386,1309,1031,1600,2631,34079,34536,3196,3198,27113,29332,64388,67066,131454
LGA25060,276,901,1296,1634,2930,732,405,10,3,304,883,1046,1291,2337,407,205,4,0,273,908,684,1113,1797,19833,20017,3125,3100,16155,19601,39113,42718,81831
LGA25150,71,180,252,322,574,120,58,0,0,47,137,167,195,362,59,29,3,0,54,163,116,192,308,5317,5381,1016,1031,3709,4025,10042,10437,20479
LGA25250,471,1311,1913,2467,4380,1122,665,8,9,434,1323,1564,1997,3561,601,234,5,3,435,1261,1041,1498,2539,24067,24296,5388,5603,24824,28255,54279,58154,112433
LGA25340,517,1212,2303,2573,4876,1258,827,31,18,511,1238,1800,2083,3883,712,342,5,3,478,1367,1195,1712,2907,27045,27412,4782,4943,17502,22098,49329,54453,103782
LGA25430,61,167,256,301,557,141,90,5,0,63,148,209,238,447,66,34,4,3,60,178,130,215,345,2945,3000,740,762,2455,2914,6140,6676,12816
LGA25490,50,117,188,211,399,90,60,3,0,39,105,132,165,297,46,28,3,0,32,116,81,144,225,3139,3149,531,558,1924,1952,5594,5659,11253
LGA25620,50,81,167,179,346,86,50,0,0,46,79,132,129,261,41,16,0,0,30,83,71,99,170,2462,2517,524,539,1704,1614,4690,4670,9360
LGA25710,70,169,342,376,718,171,88,4,3,54,183,229,274,503,81,45,0,0,60,211,141,256,397,12604,12818,1586,1673,7618,8428,21808,22919,44727
LGA25810,35,106,172,186,358,80,65,0,0,42,130,122,195,317,51,24,0,0,40,118,91,142,233,2199,2249,394,401,1674,1745,4267,4395,8662
LGA25900,247,434,626,693,1319,251,142,13,4,221,418,485,564,1049,155,64,6,0,162,431,323,495,818,10986,11114,6728,6122,16207,18902,33921,36138,70059
LGA25990,45,41,117,90,207,38,28,0,0,31,63,69,91,160,26,5,0,0,17,48,43,53,96,1251,1259,224,229,984,914,2459,2402,4861
LGA26080,3,37,67,83,150,39,29,0,0,17,57,56,86,142,21,6,0,0,15,69,36,75,111,613,608,64,65,303,470,980,1143,2123
LGA26170,81,206,398,440,838,201,113,12,5,80,211,293,329,622,104,54,4,3,74,201,182,258,440,5311,5365,979,1008,3231,3690,9521,10063,19584
LGA26260,60,166,236,294,530,126,90,3,3,57,177,186,270,456,67,32,0,0,60,197,127,229,356,3199,3222,463,479,2066,2434,5728,6135,11863
LGA26350,245,646,923,1146,2069,476,301,12,3,234,694,722,998,1720,345,161,10,3,212,812,567,976,1543,14257,14512,4350,3823,15177,19430,33784,37765,71549
LGA26430,54,82,185,179,364,75,39,4,0,52,106,131,145,276,43,22,0,0,36,104,79,126,205,1832,1842,327,332,1238,1377,3397,3551,6948
LGA26490,53,107,241,270,511,128,78,3,0,36,118,167,196,363,69,41,3,3,46,156,118,200,318,4845,4945,930,987,2800,3113,8575,9045,17620
LGA26610,62,161,262,309,571,131,79,3,0,60,143,194,222,416,74,43,4,3,47,159,125,205,330,3685,3697,622,635,2896,2859,7203,7191,14394
LGA26670,35,44,96,91,187,49,38,0,0,21,40,70,78,148,34,16,0,0,21,53,55,69,124,1203,1233,191,203,727,695,2121,2131,4252
LGA26700,101,231,370,457,827,213,141,0,5,95,263,308,409,717,117,54,0,0,74,274,191,328,519,5067,5165,825,845,3502,4299,9394,10309,19703
LGA26730,90,271,364,502,866,200,117,0,3,84,269,284,389,673,104,55,3,0,83,284,190,339,529,5400,5464,1058,1090,4319,5404,10777,11958,22735
LGA26810,137,290,521,551,1072,249,155,8,0,135,336,392,491,883,121,72,3,3,101,322,225,397,622,7329,7618,1401,1475,5196,5881,13926,14974,28900
LGA26890,20,35,80,77,157,36,24,0,0,19,37,55,61,116,17,7,0,0,16,46,33,53,86,893,896,130,124,540,500,1563,1520,3083
LGA26980,381,1309,1997,2534,4531,1155,768,12,3,407,1486,1574,2257,3831,660,342,3,0,496,1590,1159,1932,3091,29449,29843,3243,3269,21835,27507,54527,60619,115146
LGA27070,268,784,1419,1546,2965,593,307,4,3,222,601,819,911,1730,233,94,4,0,165,469,402,563,965,31275,31487,3622,3659,21559,23614,56456,58760,115216
LGA27170,74,202,299,365,664,156,94,3,0,65,218,224,312,536,79,40,3,0,61,177,143,217,360,5866,5998,1338,1378,4568,5526,11772,12902,24674
LGA27260,172,462,748,887,1635,329,170,3,5,126,478,458,653,1111,136,71,4,0,126,401,266,472,738,29827,30229,5300,5293,20438,22616,55565,58138,113703
LGA27350,175,424,521,695,1216,243,118,6,5,150,347,399,470,869,135,57,3,0,111,331,249,388,637,8388,8439,5072,4754,13743,16375,27203,29568,56771
LGA27450,253,676,1212,1362,2574,610,381,12,0,254,732,876,1113,1989,284,143,0,3,245,672,529,818,1347,27318,27628,5256,5360,19354,21523,51928,54511,106439
LGA27630,31,73,138,145,283,81,58,0,0,42,85,123,143,266,41,16,0,0,32,95,73,111,184,1408,1406,182,187,941,998,2531,2591,5122
LGA29399,3,0,3,0,3,0,0,0,0,0,3,0,3,3,0,0,0,0,0,0,0,0,0,43,45,8,11,70,39,121,95,216
LGA30250,0,5,0,8,8,3,0,0,0,3,0,6,0,6,0,0,0,0,6,0,6,0,6,34,35,140,144,258,256,432,435,867
LGA30300,11,19,44,34,78,17,6,0,0,12,17,29,23,52,0,4,0,0,4,19,4,23,27,770,770,184,193,545,487,1499,1450,2949
LGA30370,34,80,132,152,284,59,25,3,3,28,65,90,93,183,23,18,0,0,24,52,47,70,117,2736,2772,508,529,1686,1418,4930,4719,9649
LGA30410,14,21,39,39,78,15,4,0,0,14,22,29,26,55,7,0,0,0,5,20,12,20,32,557,586,123,126,392,355,1072,1067,2139
LGA30450,4,0,4,0,4,0,0,0,0,0,0,0,0,0,0,0,0,0,3,0,3,0,3,51,56,18,17,45,27,114,100,214
LGA30760,15,22,30,30,60,10,7,0,0,3,21,13,28,41,6,3,0,0,8,7,14,10,24,397,410,91,97,249,265,737,772,1509
LGA30900,3,3,3,3,6,3,0,0,0,0,0,3,0,3,0,0,0,0,0,0,0,0,0,52,54,33,34,89,55,174,143,317
LGA31000,2154,5952,8391,10690,19081,4432,2854,64,28,1949,6391,6445,9273,15718,2518,1235,36,24,1951,6991,4505,8250,12755,174806,178319,39076,39517,158937,181662,372819,399498,772317
LGA31750,3,0,3,0,3,3,3,0,0,3,0,6,3,9,0,0,0,0,0,0,0,0,0,46,53,20,25,35,26,101,104,205
LGA31820,383,687,1387,1439,2826,653,368,18,8,300,629,971,1005,1976,323,149,3,6,251,590,577,745,1322,16492,17119,2957,3156,11370,13304,30819,33579,64398
LGA31900,50,143,233,273,506,102,67,3,0,53,153,158,220,378,62,16,0,0,33,138,95,154,249,3356,3429,514,556,2159,2254,6029,6239,12268
LGA31950,0,3,0,3,3,0,0,0,0,3,0,3,0,3,0,0,0,0,0,0,0,0,0,37,38,25,23,50,35,112,96,208
LGA32070,350,613,1139,1111,2250,419,243,11,11,258,602,688,856,1544,218,94,3,0,216,617,437,711,1148,22409,23575,7358,7671,21126,23711,50893,54957,105850
LGA32250,7,3,17,7,24,6,3,3,0,3,3,12,6,18,0,0,0,0,4,3,4,3,7,213,223,113,130,286,233,612,586,1198
LGA32260,117,174,395,365,760,170,79,3,0,85,168,258,247,505,78,36,0,0,50,145,128,181,309,4818,4913,1120,1153,4056,3502,9994,9568,19562
LGA32270,48,54,117,109,226,39,18,0,0,25,40,64,58,122,13,10,0,0,24,34,37,44,81,4675,4836,1243,1283,3350,2431,9268,8550,17818
LGA32310,33,83,144,163,307,47,32,0,4,27,64,74,100,174,32,11,3,0,17,67,52,78,130,1891,2002,440,478,1390,1614,3721,4094,7815
LGA32330,5,3,5,3,8,0,0,0,0,0,3,0,3,3,0,0,0,0,0,0,0,0,0,33,31,112,116,171,232,316,379,695
LGA32450,8,8,19,12,31,0,5,0,0,6,0,6,5,11,3,0,0,0,3,8,6,8,14,326,337,170,167,394,349,890,853,1743
LGA32500,12,4,30,13,43,6,4,0,0,14,8,20,12,32,3,0,0,0,4,6,7,6,13,424,430,223,229,563,424,1210,1083,2293
LGA32600,3,0,3,0,3,0,0,0,0,3,0,3,0,3,3,0,0,0,0,0,3,0,3,38,38,18,22,43,20,99,80,179
LGA32750,0,0,0,0,0,0,0,0,0,3,0,3,0,3,0,0,0,0,0,0,0,0,0,30,38,5,12,36,28,71,78,149
LGA32770,0,3,3,3,6,0,0,0,0,3,3,3,3,6,0,0,0,0,0,0,0,0,0,66,64,124,121,156,174,346,359,705
LGA33100,5,0,9,6,15,3,0,0,0,3,4,6,4,10,3,0,0,0,0,0,3,0,3,153,156,35,36,140,60,328,252,580
LGA33200,7,5,13,14,27,10,3,0,0,7,13,17,16,33,0,4,0,0,0,9,0,13,13,321,318,71,79,212,170,604,567,1171
LGA33220,440,739,1656,1612,3268,708,403,30,15,285,697,1023,1115,2138,336,163,7,7,294,617,637,787,1424,17408,18035,3338,3619,11689,14204,32435,35858,68293
LGA33360,108,190,392,356,748,138,89,0,0,76,176,214,265,479,61,23,0,4,48,128,109,155,264,9844,10119,2673,2761,7496,5946,20013,18826,38839
LGA33430,1303,2997,5179,5722,10901,2524,1655,73,39,1076,3089,3673,4783,8456,1528,742,49,13,1098,3098,2675,3853,6528,83196,85101,20300,20786,68233,81409,171729,187296,359025
LGA33610,41,67,115,127,242,50,27,0,0,30,59,80,86,166,19,7,0,0,23,56,42,63,105,1867,1894,384,398,1204,1215,3455,3507,6962
LGA33620,180,286,661,609,1270,294,155,6,3,126,266,426,424,850,127,57,4,0,101,284,232,341,573,8410,8676,1588,1717,5772,6309,15770,16702,32472
LGA33800,55,118,228,225,453,101,60,4,0,41,124,146,184,330,55,12,0,0,30,106,85,118,203,2328,2383,371,381,1573,1419,4272,4183,8455
LGA33830,3,3,3,3,6,0,0,0,0,3,0,3,0,3,0,0,0,0,3,3,3,3,6,38,37,96,96,190,153,324,286,610
LGA33960,310,786,1146,1429,2575,515,295,8,3,250,727,773,1025,1798,246,115,5,0,203,668,454,783,1237,26384,26978,6979,7268,22683,25004,56046,59250,115296
LGA33980,17,36,58,62,120,18,15,0,0,18,31,36,46,82,11,0,0,0,9,20,20,20,40,3551,3632,1007,1052,2351,1535,6909,6219,13128
LGA34420,0,0,0,0,0,0,0,0,0,0,0,0,0,0,0,0,0,0,0,0,0,0,0,21,24,128,123,182,217,331,364,695
LGA34570,0,3,3,3,6,0,0,0,0,0,0,0,0,0,0,0,0,0,0,0,0,0,0,21,17,40,43,85,107,146,167,313
LGA34580,110,188,377,352,729,138,66,3,3,65,173,206,242,448,70,29,3,0,52,165,125,194,319,6175,6384,1178,1228,4422,4840,11775,12452,24227
LGA34590,473,1158,1799,2035,3834,715,413,18,14,389,920,1122,1347,2469,349,170,9,0,309,873,667,1043,1710,46321,47189,11085,11507,38447,42043,95853,100739,196592
LGA34710,15,28,37,46,83,15,10,0,0,12,26,27,36,63,8,3,0,0,6,28,14,31,45,615,632,198,216,469,538,1282,1386,2668
LGA34770,257,553,909,1044,1953,412,239,9,4,184,522,605,765,1370,192,96,3,0,128,437,323,533,856,18615,20176,4684,5165,14397,13449,37696,38790,76486
LGA34800,3,7,6,7,13,5,0,0,0,0,5,5,5,10,0,3,0,0,0,4,0,7,7,133,133,26,28,116,96,275,257,532
LGA34830,0,3,0,3,3,3,0,0,0,0,0,3,0,3,0,0,0,0,3,3,3,3,6,12,8,31,30,54,47,97,85,182
LGA34860,43,65,127,121,248,50,26,4,4,34,53,88,83,171,10,6,0,0,20,41,30,47,77,2133,2231,538,572,1447,1383,4118,4186,8304
LGA35010,894,2090,3546,4013,7559,1669,990,32,16,769,2033,2470,3039,5509,827,389,15,13,725,1966,1567,2368,3935,68943,70702,14044,14642,46794,55450,129781,140794,270575
LGA35250,3,3,3,6,9,0,0,0,0,0,3,0,3,3,0,0,0,0,0,0,0,0,0,49,50,116,115,160,194,325,359,684
LGA35300,41,37,105,77,182,22,6,0,0,25,43,47,49,96,6,0,0,0,9,31,15,31,46,2587,2622,1131,1169,2873,2179,6591,5970,12561
LGA35600,19,28,45,48,93,21,11,0,0,12,39,33,50,83,10,3,0,0,9,23,19,26,45,731,752,204,220,507,584,1442,1556,2998
LGA35670,0,5,4,5,9,0,0,0,0,0,4,0,4,4,0,0,0,0,0,0,0,0,0,10,15,100,97,158,139,268,251,519
LGA35760,49,63,158,136,294,74,36,0,0,34,76,108,112,220,28,15,0,0,29,65,57,80,137,1898,1946,356,378,1326,1240,3580,3564,7144
LGA35780,3,10,7,10,17,0,0,0,0,5,3,5,3,8,0,0,0,0,0,6,0,6,6,132,138,190,185,315,363,637,686,1323
LGA35790,0,0,3,5,8,3,0,0,0,0,5,3,5,8,0,0,0,0,0,3,0,3,3,52,52,187,191,462,433,701,676,1377
LGA35800,7,11,22,20,42,4,3,0,0,6,10,10,13,23,3,0,0,0,4,9,7,9,16,256,264,84,86,288,233,628,583,1211
LGA36070,0,4,4,4,8,0,0,0,0,0,0,0,0,0,0,0,0,0,0,0,0,0,0,24,25,84,84,118,117,226,226,452
LGA36150,4,11,9,14,23,0,0,0,0,5,3,5,3,8,0,0,0,0,4,3,4,3,7,149,149,43,51,139,102,331,302,633
LGA36250,327,832,1417,1626,3043,747,483,22,10,314,900,1083,1393,2476,440,206,11,11,315,899,766,1116,1882,26899,27597,4740,4897,17457,20744,49096,53238,102334
LGA36300,6,4,12,9,21,3,0,0,0,3,5,6,5,11,0,0,0,0,9,6,9,6,15,140,139,43,43,111,78,294,260,554
LGA36360,363,730,1183,1349,2532,536,327,10,0,274,642,820,969,1789,216,86,4,6,191,646,411,738,1149,17303,18466,4063,4486,13844,15488,35210,38440,73650
LGA36510,112,228,509,468,977,224,121,3,0,62,191,289,312,601,97,50,0,0,98,200,195,250,445,7144,7292,1232,1281,4376,4861,12752,13434,26186
LGA36580,84,115,253,223,476,73,37,0,0,62,105,135,142,277,47,17,0,0,38,101,85,118,203,4000,4085,864,908,2712,2798,7576,7791,15367
LGA36630,125,213,472,436,908,175,95,9,3,97,230,281,328,609,105,41,3,3,73,171,181,215,396,5687,5859,1048,1099,3956,4235,10691,11193,21884
LGA36660,121,275,503,518,1021,205,121,10,4,95,288,310,413,723,112,50,0,0,81,270,193,320,513,6314,6471,1113,1170,4077,4889,11504,12530,24034
LGA36710,893,2088,4408,4622,9030,2196,1359,43,30,822,2236,3061,3625,6686,1283,606,18,6,795,2272,2096,2884,4980,56672,58713,11510,12128,36758,46954,104940,117795,222735
LGA36810,202,300,663,579,1242,277,139,9,5,115,288,401,432,833,132,51,8,0,106,260,246,311,557,7258,7606,1701,1797,5649,6085,14608,15488,30096
LGA36910,440,1118,1764,2107,3871,821,526,11,4,337,1088,1169,1618,2787,475,209,10,5,318,1038,803,1252,2055,26950,27877,4532,4757,17971,22460,49453,55094,104547
LGA36950,3,3,3,3,6,0,3,0,0,3,11,3,14,17,0,0,0,0,3,5,3,5,8,270,275,192,197,403,438,865,910,1775
LGA36960,8,9,13,12,25,4,3,0,0,5,12,9,15,24,0,3,0,0,4,3,4,6,10,261,257,305,304,536,620,1102,1181,2283
LGA37010,377,834,1197,1438,2635,549,318,7,5,303,757,859,1080,1939,251,127,3,0,219,692,473,819,1292,25965,27671,7774,8522,23667,25426,57406,61619,119025
LGA37300,0,0,0,0,0,0,0,0,0,3,0,3,0,3,0,0,0,0,0,0,0,0,0,470,466,207,215,366,226,1043,907,1950
LGA37310,104,148,359,309,668,143,84,4,0,90,175,237,259,496,73,29,0,0,75,164,148,193,341,5519,5611,1079,1116,3761,3514,10359,10241,20600
LGA37340,85,150,274,278,552,98,58,3,3,77,112,178,173,351,45,22,4,0,50,101,99,123,222,4655,4878,1466,1570,4074,3425,10195,9873,20068
LGA37400,10,9,23,17,40,3,3,0,0,12,6,15,9,24,3,0,0,0,3,10,6,10,16,229,235,47,51,192,155,468,441,909
LGA37550,0,0,4,0,4,0,0,0,0,0,0,0,0,0,0,0,0,0,0,0,0,0,0,21,23,72,76,159,203,252,302,554
LGA37570,0,3,0,3,3,0,0,0,0,0,0,0,0,0,0,0,0,0,0,0,0,0,0,11,10,33,36,51,59,95,105,200
LGA37600,4,6,4,6,10,0,0,0,0,0,4,0,4,4,0,0,0,0,5,4,5,4,9,114,114,144,145,450,495,708,754,1462
LGA39399,0,0,0,0,0,0,0,0,0,0,0,0,0,0,0,0,0,0,0,0,0,0,0,0,0,0,0,0,0,0,0,0
LGA40070,43,83,103,136,239,57,38,3,0,40,85,100,123,223,49,13,0,0,38,102,87,115,202,1928,1939,847,790,4222,4167,6997,6896,13893
LGA40120,61,166,372,371,743,179,105,0,0,68,176,247,281,528,97,48,4,0,49,192,150,240,390,8128,8282,1313,1359,4492,4639,13933,14280,28213
LGA40220,86,180,437,427,864,213,148,11,5,81,181,305,334,639,102,42,5,3,54,176,161,221,382,4825,4909,898,923,2787,3299,8510,9131,17641
LGA40250,3,4,11,7,18,3,0,0,0,3,9,6,9,15,0,0,0,3,9,0,9,3,12,314,314,60,66,408,448,782,828,1610
LGA40310,61,147,315,318,633,137,105,0,0,52,170,189,275,464,92,43,0,0,50,202,142,245,387,4611,4711,787,827,2563,2782,7961,8320,16281
LGA40430,13,26,53,57,110,20,12,0,0,15,22,35,34,69,16,4,0,0,14,27,30,31,61,508,514,79,79,327,276,914,869,1783
LGA40520,38,85,161,190,351,80,36,0,3,33,86,113,125,238,30,14,0,0,22,105,52,119,171,1856,1904,392,410,1431,1577,3679,3891,7570
LGA40700,106,383,583,714,1297,373,247,8,3,128,501,509,751,1260,223,116,8,3,144,642,375,761,1136,8344,8512,972,970,5570,7683,14886,17165,32051
LGA40910,174,476,823,935,1758,444,258,8,0,126,468,578,726,1304,193,79,0,0,140,434,333,513,846,9756,9898,1088,1103,6961,8655,17805,19656,37461
LGA41010,4,15,22,28,50,15,10,0,0,6,20,21,30,51,7,3,0,0,4,13,11,16,27,489,510,219,233,487,421,1195,1164,2359
LGA41060,332,971,1535,1847,3382,882,529,14,9,390,1064,1286,1602,2888,506,244,6,5,380,1217,892,1466,2358,18860,19072,3231,3337,17196,19575,39287,41984,81271
LGA41140,38,47,139,96,235,50,37,4,0,30,62,84,99,183,23,13,0,0,18,78,41,91,132,1743,1778,304,323,1023,1063,3070,3164,6234
LGA41190,8,10,17,29,46,12,10,0,0,6,13,18,23,41,3,0,3,0,0,12,6,12,18,358,356,51,54,224,162,633,572,1205
LGA41330,19,5,31,9,40,6,3,0,0,3,0,9,3,12,0,0,0,0,0,4,0,4,4,190,194,103,104,343,192,636,490,1126
LGA41560,59,139,216,281,497,112,66,8,0,51,131,171,197,368,59,25,0,3,40,112,99,140,239,2518,2572,469,493,1608,1947,4595,5012,9607
LGA41750,8,5,15,9,24,7,3,0,0,0,4,7,7,14,0,0,0,0,0,5,0,5,5,208,209,38,42,141,99,387,350,737
LGA41830,7,8,32,19,51,6,9,3,0,11,7,20,16,36,4,0,0,0,0,15,4,15,19,299,315,64,70,215,225,578,610,1188
LGA41960,0,6,11,18,29,7,7,0,0,3,5,10,12,22,11,0,0,0,0,10,11,10,21,244,251,58,59,139,112,441,422,863
LGA42030,79,177,315,365,680,183,121,0,0,52,176,235,297,532,87,33,3,3,70,183,160,219,379,3702,3764,716,754,2816,3562,7234,8080,15314
LGA42110,24,35,75,70,145,20,9,0,0,16,37,36,46,82,17,4,0,0,17,42,34,46,80,783,793,149,148,593,561,1525,1502,3027
LGA42250,20,13,79,49,128,32,14,0,0,20,34,52,48,100,11,12,0,0,13,20,24,32,56,1663,1686,246,250,913,689,2822,2625,5447
LGA42600,121,367,458,661,1119,287,212,5,4,126,483,418,699,1117,215,130,0,3,165,685,380,818,1198,6048,6178,1148,1192,5106,6696,12302,14066,26368
LGA42750,10,26,48,53,101,23,10,0,0,9,27,32,37,69,19,14,0,0,17,31,36,45,81,816,821,194,202,528,475,1538,1498,3036
LGA43080,3,12,18,24,42,11,7,0,0,0,10,11,17,28,3,0,0,0,7,4,10,4,14,230,226,20,24,155,109,405,359,764
LGA43220,9,11,18,18,36,10,8,0,0,6,13,16,21,37,4,6,0,0,3,5,7,11,18,239,240,25,25,115,91,379,356,735
LGA43360,11,19,54,46,100,13,11,3,4,3,14,19,29,48,6,5,3,0,5,14,14,19,33,443,446,84,92,290,274,817,812,1629
LGA43650,21,63,120,112,232,59,36,3,0,15,42,77,78,155,23,14,0,0,21,59,44,73,117,2848,2916,446,446,1614,1564,4908,4926,9834
LGA43710,15,18,47,40,87,24,16,3,0,19,9,46,25,71,10,5,0,0,9,23,19,28,47,916,948,206,210,578,434,1700,1592,3292
LGA43790,33,86,149,181,330,79,33,3,0,31,87,113,120,233,46,17,0,3,44,124,90,144,234,2261,2286,378,393,1476,1450,4115,4129,8244
LGA43920,19,24,69,52,121,23,16,0,0,9,26,32,42,74,12,3,0,0,7,25,19,28,47,1588,1607,355,385,1153,1026,3096,3018,6114
LGA44000,0,0,0,0,0,0,0,0,0,0,0,0,0,0,0,0,0,0,0,0,0,0,0,0,0,12,15,10,9,22,24,46
LGA44060,222,735,997,1346,2343,665,443,4,11,233,845,902,1299,2201,347,178,10,3,297,888,654,1069,1723,14758,15015,2864,2949,12722,15621,30344,33585,63929
LGA44210,39,41,143,96,239,45,32,3,0,33,70,81,102,183,19,9,0,0,22,50,41,59,100,1536,1552,282,301,1232,976,3050,2829,5879
LGA44340,156,443,815,948,1763,491,324,7,3,165,545,663,872,1535,333,173,4,3,212,723,549,899,1448,12587,12845,1719,1777,8304,10054,22610,24676,47286
LGA44550,49,154,231,287,518,129,73,3,0,39,155,171,228,399,56,23,0,0,55,154,111,177,288,5611,5767,1163,1207,3357,4265,10131,11239,21370
LGA44620,84,196,292,350,642,179,89,3,7,62,214,244,310,554,65,32,0,0,62,204,127,236,363,4229,4321,974,1003,3414,4178,8617,9502,18119
LGA44830,16,18,58,44,102,20,11,0,0,17,19,37,30,67,8,4,0,0,13,23,21,27,48,585,608,93,110,365,309,1043,1027,2070
LGA45040,75,138,295,298,593,141,89,3,0,48,149,192,238,430,62,21,0,3,47,173,109,197,306,3278,3329,754,792,2856,3114,6888,7235,14123
LGA45090,16,62,83,110,193,47,33,0,0,18,57,65,90,155,34,24,0,0,18,63,52,87,139,1622,1637,307,321,1030,851,2959,2809,5768
LGA45120,19,43,65,80,145,39,19,0,0,11,42,50,61,111,16,13,0,0,14,42,30,55,85,924,951,136,149,603,530,1663,1630,3293
LGA45290,113,364,423,620,1043,275,184,3,3,117,376,395,563,958,171,74,3,0,124,486,298,560,858,5643,5726,1173,1205,5803,7340,12619,14271,26890
LGA45340,323,872,1559,1771,3330,877,534,18,6,309,886,1204,1426,2630,431,225,10,0,269,846,710,1071,1781,29173,29763,6314,6531,21754,24676,57241,60970,118211
LGA45400,3,6,8,14,22,8,7,0,0,3,14,11,21,32,7,4,0,0,3,9,10,13,23,181,187,24,24,110,113,315,324,639
LGA45540,11,13,45,29,74,11,0,0,3,12,22,23,25,48,4,4,0,0,11,12,15,16,31,274,283,48,53,298,297,620,633,1253
LGA45680,204,471,798,922,1720,361,216,9,4,172,436,542,656,1198,131,59,4,3,140,305,275,367,642,11616,11805,3436,3544,12302,13406,27354,28755,56109
LGA45890,332,891,1222,1625,2847,708,437,15,11,336,1023,1059,1471,2530,399,180,7,4,378,1036,784,1220,2004,17847,18085,3761,3958,19699,21270,41307,43313,84620
LGA46090,45,103,123,160,283,58,37,0,0,35,109,93,146,239,21,8,0,0,21,54,42,62,104,1877,1959,638,695,1835,2042,4350,4696,9046
LGA46300,31,108,144,199,343,100,58,6,6,37,105,143,169,312,43,26,0,3,40,102,83,131,214,2210,2282,604,646,1932,2223,4746,5151,9897
LGA46450,80,146,260,282,542,114,71,3,0,65,169,182,240,422,60,22,0,0,51,158,111,180,291,2961,3046,629,662,2440,2765,6030,6473,12503
LGA46510,52,138,187,235,422,103,60,3,0,43,156,149,216,365,74,34,0,0,54,194,128,228,356,3526,3578,626,651,3331,3576,7483,7805,15288
LGA46670,22,68,111,134,245,70,27,0,0,28,83,98,110,208,27,12,0,0,22,77,49,89,138,1683,1699,306,317,1294,1365,3283,3381,6664
LGA46860,0,10,6,21,27,14,0,0,0,6,13,20,13,33,6,4,0,0,4,5,10,9,19,257,252,74,78,161,140,492,470,962
LGA46970,0,5,0,5,5,0,0,0,0,0,0,0,0,0,0,0,0,0,0,0,0,0,0,628,643,292,300,481,276,1401,1219,2620
LGA47140,290,723,1229,1362,2591,510,289,15,6,235,660,760,955,1715,220,99,5,5,201,541,426,645,1071,21986,22327,4714,4830,19901,21207,46601,48364,94965
LGA47290,11,16,26,30,56,11,8,0,0,11,9,22,17,39,14,7,0,0,9,18,23,25,48,422,419,68,71,282,217,772,707,1479
LGA47490,7,15,24,23,47,8,8,0,0,8,17,16,25,41,12,9,0,0,7,7,19,16,35,357,367,93,94,280,177,730,638,1368
LGA47630,21,32,87,80,167,48,27,0,0,9,45,57,72,129,15,13,0,0,18,55,33,68,101,1290,1297,230,229,874,684,2394,2210,4604
LGA47700,191,572,1068,1208,2276,541,336,12,3,163,533,716,872,1588,269,118,6,5,143,577,418,700,1118,19673,19966,2983,3061,12578,14571,35234,37598,72832
LGA47800,22,32,77,67,144,27,15,0,0,20,33,47,48,95,16,6,0,0,19,32,35,38,73,1040,1054,184,186,742,645,1966,1885,3851
LGA47910,12,25,57,51,108,15,8,0,0,10,31,25,39,64,9,10,0,0,16,38,25,48,73,550,552,66,68,313,299,929,919,1848
LGA47980,92,265,336,452,788,201,141,3,0,82,328,286,469,755,139,79,0,0,114,396,253,475,728,6250,6389,1269,1309,5158,6819,12677,14517,27194
LGA48050,54,144,360,387,747,228,154,3,3,60,190,291,347,638,137,73,0,0,87,186,224,259,483,2937,2982,388,416,1432,2007,4757,5405,10162
LGA48130,23,45,76,100,176,41,26,0,0,24,45,65,71,136,25,12,0,0,19,66,44,78,122,1180,1211,239,245,955,847,2374,2303,4677
LGA48260,20,66,87,130,217,71,48,0,0,27,78,98,126,224,32,8,0,0,25,92,57,100,157,1347,1388,145,146,1026,1193,2518,2727,5245
LGA48340,21,86,136,172,308,74,33,0,0,40,108,114,141,255,29,15,0,0,31,77,60,92,152,2182,2211,446,469,1519,1499,4147,4179,8326
LGA48410,162,502,796,980,1776,439,297,12,4,194,622,645,923,1568,299,130,4,3,237,642,540,775,1315,9213,9341,1860,1956,9729,10810,20802,22107,42909
LGA48540,86,159,257,283,540,120,61,0,4,51,139,171,204,375,30,18,3,0,36,120,69,138,207,3411,3472,964,983,3481,3418,7856,7873,15729
LGA48640,0,11,9,17,26,5,7,0,0,6,14,11,21,32,5,0,0,0,7,18,12,18,30,260,264,40,32,139,124,439,420,859
LGA48750,18,33,88,74,162,36,24,0,3,15,30,51,57,108,20,8,0,0,9,34,29,42,71,899,905,186,199,570,556,1655,1660,3315
LGA48830,69,80,255,230,485,122,75,6,0,53,116,181,191,372,43,31,0,0,51,92,94,123,217,2291,2296,370,384,1447,1249,4108,3929,8037
LGA49399,22,6,25,13,38,7,0,0,0,7,3,14,3,17,0,0,0,0,4,5,4,5,9,443,439,220,213,617,377,1280,1029,2309
LGA50080,109,247,462,485,947,227,147,10,0,99,258,336,405,741,117,56,3,0,92,266,212,322,534,5792,5991,1304,1409,3931,4808,11027,12208,23235
LGA50210,122,309,501,580,1081,218,146,6,6,109,266,333,418,751,107,40,0,0,94,226,201,266,467,10343,10777,2580,2773,8630,9068,21553,22618,44171
LGA50250,0,7,4,7,11,0,0,0,0,0,3,0,3,3,0,0,0,0,3,0,3,0,3,852,857,402,402,656,427,1910,1686,3596
LGA50280,16,54,97,111,208,55,33,0,0,22,53,77,86,163,28,16,5,0,23,57,56,73,129,1840,1947,565,607,1295,1343,3700,3897,7597
LGA50350,69,127,198,215,413,64,41,0,0,37,136,101,177,278,51,23,0,0,36,96,87,119,206,2274,2348,639,676,2358,2497,5271,5521,10792
LGA50420,177,449,675,794,1469,319,199,6,6,134,386,459,591,1050,193,92,3,3,147,452,343,547,890,10446,10689,2321,2421,10166,10447,22933,23557,46490
LGA50490,122,312,372,520,892,185,104,3,3,102,263,290,370,660,107,50,0,0,84,248,191,298,489,5219,5349,1368,1439,6200,6238,12787,13026,25813
LGA50560,10,13,25,27,52,13,8,0,0,6,10,19,18,37,6,3,0,0,6,12,12,15,27,312,319,56,60,213,167,581,546,1127
LGA50630,3,8,17,15,32,4,3,0,0,4,3,8,6,14,3,0,0,0,5,6,8,6,14,285,289,87,89,162,164,534,542,1076
LGA50770,5,13,17,21,38,8,3,0,0,0,12,8,15,23,4,4,0,0,5,8,9,12,21,314,323,59,65,161,154,534,542,1076
LGA50840,13,24,59,48,107,18,14,0,0,10,24,28,38,66,14,3,0,0,5,18,19,21,40,818,857,178,195,456,534,1452,1586,3038
LGA50910,4,5,14,15,29,5,4,0,0,0,7,5,11,16,3,0,0,0,5,3,8,3,11,168,173,36,42,96,80,300,295,595
LGA50980,31,13,58,32,90,8,0,0,0,27,31,35,31,66,6,4,0,0,10,10,16,14,30,1514,1590,945,1000,2019,1975,4478,4565,9043
LGA51080,3,6,7,11,18,6,5,0,0,0,4,6,9,15,4,0,0,0,0,7,4,7,11,223,217,36,40,123,112,382,369,751
LGA51120,0,7,10,14,24,7,3,0,0,3,8,10,11,21,3,0,0,0,3,10,6,10,16,200,202,26,30,114,96,340,328,668
LGA51190,71,226,303,435,738,182,121,4,4,76,245,262,370,632,103,35,0,3,86,233,189,271,460,4879,5063,1319,1403,4485,5063,10683,11529,22212
LGA51260,65,189,352,430,782,193,133,7,0,71,214,271,347,618,104,37,3,0,59,212,166,249,415,5311,5654,1182,1281,3080,3907,9573,10842,20415
LGA51310,41,186,239,376,615,177,105,4,3,48,185,229,293,522,125,68,0,0,74,262,199,330,529,4840,5002,678,692,3161,3615,8679,9309,17988
LGA51330,161,476,757,873,1630,395,236,7,6,138,479,540,721,1261,206,103,3,3,123,497,332,603,935,15336,15879,2154,2293,14494,14794,31984,32966,64950
LGA51400,12,36,69,73,142,45,20,0,0,9,25,54,45,99,13,4,0,0,5,24,18,28,46,2616,2802,543,594,1321,1440,4480,4836,9316
LGA51470,5,5,9,8,17,0,0,0,0,4,4,4,4,8,0,0,0,0,0,0,0,0,0,94,94,23,31,68,48,185,173,358
LGA51540,16,25,47,40,87,11,8,5,0,13,20,29,28,57,3,3,0,0,7,20,10,23,33,748,779,294,315,774,661,1816,1755,3571
LGA51610,4,3,12,6,18,3,3,0,0,6,0,9,3,12,0,0,0,0,0,0,0,0,0,240,256,45,48,127,78,412,382,794
LGA51680,10,13,43,31,74,14,10,0,0,3,10,17,20,37,6,0,0,0,7,8,13,8,21,898,975,150,169,434,434,1482,1578,3060
LGA51750,29,85,107,159,266,66,47,0,3,26,120,92,170,262,54,25,0,0,31,163,85,188,273,1562,1603,246,258,1231,1758,3039,3619,6658
LGA51820,174,457,773,843,1616,297,173,5,0,143,413,445,586,1031,114,53,3,3,112,357,229,413,642,16070,16790,3276,3538,12037,13013,31383,33341,64724
LGA51890,37,60,99,113,212,39,17,0,0,24,52,63,69,132,21,10,3,0,12,57,36,67,103,1484,1523,399,413,1236,1145,3119,3081,6200
LGA51960,6,5,15,12,27,0,0,3,0,0,7,3,7,10,0,0,0,0,5,0,5,0,5,477,480,248,243,513,357,1238,1080,2318
LGA52030,11,6,23,18,41,4,5,0,0,0,4,4,9,13,3,0,0,0,0,3,3,3,6,197,196,49,54,146,87,392,337,729
LGA52100,3,8,14,18,32,7,6,0,0,0,10,7,16,23,8,4,0,0,4,9,12,13,25,216,215,40,38,132,106,388,359,747
LGA52170,17,49,68,83,151,37,28,0,3,12,57,49,88,137,19,6,0,0,17,79,36,85,121,1267,1326,251,259,1015,1199,2533,2784,5317
LGA52240,4,6,13,16,29,4,3,0,0,3,3,7,6,13,8,0,0,0,0,4,8,4,12,209,207,40,46,142,79,391,332,723
LGA52310,0,0,11,6,17,9,4,0,0,0,0,9,4,13,0,3,0,0,0,4,0,7,7,182,192,36,38,100,71,318,301,619
LGA52380,0,3,0,3,3,0,0,0,0,0,0,0,0,0,0,0,0,0,0,3,0,3,3,34,33,15,12,46,37,95,82,177
LGA52450,3,4,23,14,37,10,3,0,0,5,9,15,12,27,4,3,0,0,3,9,7,12,19,249,251,39,44,157,121,445,416,861
LGA52520,3,7,15,17,32,9,4,0,0,4,7,13,11,24,3,3,0,0,3,3,6,6,12,237,246,58,57,179,115,474,418,892
LGA52590,10,12,47,42,89,15,15,0,0,11,10,26,25,51,7,3,0,0,6,14,13,17,30,552,576,133,136,331,238,1016,950,1966
LGA52660,25,50,127,121,248,62,28,0,0,11,51,73,79,152,30,12,0,3,22,43,52,58,110,2214,2341,539,597,1329,1392,4082,4330,8412
LGA52730,15,37,73,76,149,33,19,0,0,13,38,46,57,103,16,8,0,3,15,41,31,52,83,918,953,209,226,551,684,1678,1863,3541
LGA52800,17,18,28,18,46,0,3,0,0,15,11,15,14,29,3,0,0,0,0,6,3,6,9,503,516,390,403,928,964,1821,1883,3704
LGA52870,15,23,63,57,120,27,10,0,0,9,23,36,33,69,14,5,0,0,6,26,20,31,51,1016,1086,222,235,573,580,1811,1901,3712
LGA52940,0,4,7,8,15,5,3,0,0,0,11,5,14,19,6,4,0,0,4,8,10,12,22,151,156,23,27,65,63,239,246,485
LGA53010,3,4,6,4,10,4,3,0,0,0,0,4,3,7,0,0,0,0,0,4,0,4,4,132,130,26,25,81,46,239,201,440
LGA53080,4,3,8,6,14,0,3,0,0,3,3,3,6,9,0,3,0,0,0,4,0,7,7,108,111,58,57,136,114,302,282,584
LGA53150,14,51,75,92,167,38,24,0,0,16,48,54,72,126,17,4,4,0,17,51,38,55,93,1219,1255,260,296,879,1084,2358,2635,4993
LGA53220,3,7,7,7,14,0,0,0,0,0,6,0,6,6,0,0,0,0,3,3,3,3,6,805,818,328,331,814,605,1947,1754,3701
LGA53290,28,82,113,162,275,65,38,0,0,37,65,102,103,205,24,14,0,0,23,66,47,80,127,2205,2308,550,596,1550,1577,4305,4481,8786
LGA53360,15,4,22,15,37,8,3,0,3,3,0,11,6,17,0,0,0,0,3,3,3,3,6,356,372,144,156,306,198,806,726,1532
LGA53430,108,212,341,395,736,172,96,0,0,74,222,246,318,564,94,31,0,0,64,202,158,233,391,3862,3993,1230,1330,4233,5012,9325,10335,19660
LGA53520,94,203,358,397,755,173,77,7,0,76,177,256,254,510,69,34,4,0,57,160,130,194,324,5588,5983,1524,1694,4622,5030,11734,12707,24441
LGA53570,13,17,65,59,124,24,8,0,0,12,15,36,23,59,9,4,0,0,10,21,19,25,44,888,945,183,198,508,419,1579,1562,3141
LGA53640,3,9,6,12,18,3,3,0,0,3,4,6,7,13,0,3,0,0,0,3,0,6,6,245,235,42,45,162,104,449,384,833
LGA53710,10,3,19,6,25,3,3,0,0,7,3,10,6,16,0,3,0,0,3,0,3,3,6,183,188,40,42,109,109,332,339,671
LGA53780,163,526,768,969,1737,395,219,12,3,157,425,564,647,1211,172,73,0,0,128,386,300,459,759,18328,19036,3559,3773,15229,15972,37116,38781,75897
LGA53920,6,8,6,8,14,0,0,0,0,3,3,3,3,6,0,0,0,0,3,7,3,7,10,261,263,147,142,507,606,915,1011,1926
LGA53990,42,80,205,182,387,86,54,0,0,29,86,115,140,255,47,11,3,0,26,86,76,97,173,4293,4507,868,951,2546,2571,7707,8029,15736
LGA54060,12,21,56,48,104,32,17,0,5,13,9,45,31,76,11,6,0,0,7,17,18,23,41,635,685,146,175,345,387,1126,1247,2373
LGA54130,3,10,3,10,13,3,6,0,0,3,0,6,6,12,3,0,0,0,0,0,3,0,3,190,191,47,49,126,58,363,298,661
LGA54170,220,672,1162,1416,2578,635,406,12,3,188,663,835,1072,1907,330,171,3,0,194,695,527,866,1393,30676,32069,4486,4813,19573,21587,54735,58469,113204
LGA54200,98,317,621,707,1328,296,175,6,4,71,232,373,411,784,153,59,3,0,72,300,228,359,587,10102,10621,1850,2028,6787,7454,18739,20103,38842
LGA54280,51,76,103,114,217,31,20,0,3,21,53,52,76,128,12,5,0,0,16,60,28,65,93,4189,4327,1649,1767,4053,3382,9891,9476,19367
LGA54340,4,26,33,52,85,23,8,0,0,5,29,28,37,65,8,4,0,0,8,17,16,21,37,729,745,138,143,504,559,1371,1447,2818
LGA54410,6,12,17,23,40,8,4,0,0,0,12,8,16,24,0,0,0,0,3,14,3,14,17,208,207,47,55,121,145,376,407,783
LGA54480,0,0,0,0,0,0,3,0,0,3,0,3,3,6,0,0,0,0,0,0,0,0,0,115,119,23,19,57,26,195,164,359
LGA54550,3,13,24,30,54,18,7,0,0,0,19,18,26,44,3,0,0,0,5,10,8,10,18,392,386,79,83,213,203,684,672,1356
LGA54620,4,5,10,8,18,3,0,0,0,0,0,3,0,3,0,0,0,0,3,3,3,3,6,167,174,37,36,101,68,305,278,583
LGA54690,3,0,7,8,15,4,0,0,0,3,0,7,0,7,0,3,0,0,0,0,0,3,3,82,81,19,21,52,40,153,142,295
LGA54760,0,4,6,8,14,4,0,0,0,6,7,10,7,17,7,0,0,0,0,6,7,6,13,178,178,26,29,90,56,294,263,557
LGA54830,60,140,220,238,458,94,62,4,0,34,90,132,152,284,38,26,0,0,30,91,68,117,185,4215,4412,1380,1519,3879,4107,9474,10038,19512
LGA54900,4,3,9,12,21,7,7,0,0,3,7,10,14,24,4,0,0,0,4,0,8,0,8,263,263,61,61,168,90,492,414,906
LGA54970,3,0,7,4,11,0,3,0,0,0,0,0,3,3,0,0,0,0,0,0,0,0,0,52,53,50,52,92,95,194,200,394
LGA55040,0,3,0,3,3,0,0,0,0,3,3,3,3,6,0,0,0,0,0,3,0,3,3,166,169,62,69,133,118,361,356,717
LGA55110,220,534,1109,1263,2372,608,362,15,6,171,559,794,927,1721,282,140,0,3,173,470,455,613,1068,12087,12860,2589,2922,8349,10278,23025,26060,49085
LGA55180,29,59,113,112,225,50,28,0,0,24,44,74,72,146,25,10,0,0,20,61,45,71,116,1662,1702,354,365,1104,1096,3120,3163,6283
LGA55250,0,3,3,3,6,0,3,0,0,3,3,3,6,9,0,0,0,0,0,0,0,0,0,81,80,62,64,131,139,274,283,557
LGA55320,211,706,1155,1480,2635,704,470,6,4,212,884,922,1358,2280,437,240,3,3,243,980,683,1223,1906,18549,19312,2406,2544,13162,16739,34117,38595,72712
LGA55390,3,3,3,3,6,3,0,0,0,0,0,3,0,3,0,0,0,0,0,0,0,0,0,32,31,13,15,65,61,110,107,217
LGA55460,13,11,37,32,69,20,11,0,0,13,13,33,24,57,4,3,4,0,5,13,13,16,29,562,572,123,127,419,349,1104,1048,2152
LGA55530,0,0,4,3,7,3,0,0,0,5,4,8,4,12,0,0,0,0,0,0,0,0,0,84,84,22,24,60,45,166,153,319
LGA55600,4,4,19,19,38,5,4,0,0,10,13,15,17,32,6,0,0,0,4,19,10,19,29,417,432,115,121,295,284,827,837,1664
LGA55670,0,3,16,12,28,3,0,0,0,3,7,6,7,13,0,0,0,0,0,4,0,4,4,131,133,35,35,93,92,259,260,519
LGA55740,32,55,86,100,186,31,21,0,0,26,52,57,73,130,25,18,0,0,21,79,46,97,143,1325,1393,295,308,1271,1530,2891,3231,6122
LGA55810,0,0,3,3,6,0,0,0,0,3,3,3,3,6,0,0,0,0,0,0,0,0,0,47,49,47,49,87,74,181,172,353
LGA55880,3,3,6,6,12,3,0,0,0,3,3,6,3,9,0,0,0,0,0,3,0,3,3,102,100,22,23,60,28,184,151,335
LGA55950,0,3,11,6,17,9,3,0,0,0,3,9,6,15,0,0,0,0,0,3,0,3,3,122,124,21,19,52,36,195,179,374
LGA56020,3,4,8,9,17,3,0,0,0,4,0,7,0,7,0,0,0,0,0,0,0,0,0,104,104,20,21,98,63,222,188,410
LGA56090,80,162,377,382,759,181,86,0,5,66,180,247,271,518,89,36,0,0,54,212,143,248,391,6799,7146,1240,1361,4248,4753,12287,13260,25547
LGA56160,0,0,0,0,0,0,0,0,0,3,0,3,0,3,0,0,0,0,0,0,0,0,0,16,21,3,4,15,3,34,28,62
LGA56230,48,72,247,195,442,110,73,0,5,52,55,162,133,295,44,17,3,0,24,52,71,69,140,2623,2768,522,584,1766,1592,4911,4944,9855
LGA56300,5,5,14,14,28,4,3,0,0,4,5,8,8,16,4,0,0,0,0,11,4,11,15,226,234,71,78,195,130,492,442,934
LGA56370,3,4,11,16,27,12,6,0,0,0,3,12,9,21,7,0,0,0,0,11,7,11,18,190,188,19,24,94,65,303,277,580
LGA56450,3,3,9,6,15,3,3,0,0,3,0,6,3,9,0,0,0,0,0,0,0,0,0,179,182,25,24,102,54,306,260,566
LGA56520,12,33,48,61,109,18,13,3,0,11,34,32,47,79,14,5,0,0,10,36,24,41,65,659,678,142,155,470,603,1271,1436,2707
LGA56580,29,123,223,251,474,117,73,0,0,42,148,159,221,380,82,45,0,3,49,242,131,290,421,4023,4216,374,378,2682,3220,7079,7814,14893
LGA56620,0,4,0,4,4,0,0,0,0,3,0,3,0,3,0,0,0,0,0,0,0,0,0,176,174,35,35,200,255,411,464,875
LGA56730,41,66,138,118,256,43,30,0,0,34,66,77,96,173,27,9,0,0,17,67,44,76,120,1701,1784,357,409,1299,1416,3357,3609,6966
LGA56790,13,23,46,48,94,19,12,3,0,11,16,33,28,61,8,4,4,0,12,13,24,17,41,579,622,134,158,390,318,1103,1098,2201
LGA56860,0,0,3,4,7,0,4,0,0,3,0,3,4,7,3,0,0,0,0,3,3,3,6,33,41,5,10,43,26,81,77,158
LGA56930,3,3,30,16,46,10,4,0,0,3,15,13,19,32,13,7,0,0,3,13,16,20,36,289,308,23,24,175,210,487,542,1029
LGA57000,3,0,6,4,10,5,0,0,0,0,3,5,3,8,0,0,0,0,0,3,0,3,3,99,101,35,33,54,34,188,168,356
LGA57080,38,45,92,81,173,25,16,4,0,24,44,53,60,113,18,5,0,0,18,34,36,39,75,1897,1918,984,957,3295,2535,6176,5410,11586
LGA57140,11,5,25,17,42,10,5,0,0,6,4,16,9,25,3,0,0,0,6,13,9,13,22,206,218,45,53,131,130,382,401,783
LGA57210,13,23,51,51,102,24,19,0,0,12,29,36,48,84,18,7,0,0,6,25,24,32,56,904,919,180,199,567,576,1651,1694,3345
LGA57280,9,10,9,14,23,0,0,0,0,11,5,11,5,16,3,0,0,0,5,5,8,5,13,1581,1597,790,822,1713,1145,4084,3564,7648
LGA57350,7,10,18,20,38,9,9,0,0,3,4,12,13,25,3,3,0,0,5,7,8,10,18,210,216,34,36,105,127,349,379,728
LGA57420,4,6,23,19,42,4,3,0,0,3,3,7,6,13,0,3,0,0,4,3,4,6,10,364,363,92,90,212,122,668,575,1243
LGA57490,214,522,929,1059,1988,471,326,14,7,180,485,665,818,1483,227,94,6,3,153,410,386,507,893,17205,18542,4232,4744,12645,13750,34082,37036,71118
LGA57560,9,12,18,15,33,4,7,0,0,5,3,9,10,19,3,0,0,0,4,5,7,5,12,2552,2581,1091,1121,2251,1481,5894,5183,11077
LGA57630,0,0,0,0,0,0,0,0,0,0,0,0,0,0,0,0,0,0,0,0,0,0,0,17,21,9,6,12,7,38,34,72
LGA57700,26,42,104,108,212,61,33,0,0,17,40,78,73,151,19,9,3,0,16,25,38,34,72,3251,3474,736,806,1878,1917,5865,6197,12062
LGA57770,4,3,8,12,20,6,5,0,0,8,0,14,5,19,3,0,0,0,3,3,6,3,9,135,134,58,58,113,78,306,270,576
LGA57840,71,276,294,446,740,165,122,4,0,68,285,237,407,644,119,57,0,0,100,384,219,441,660,6399,6611,1481,1537,6471,7478,14351,15626,29977
LGA57910,544,1556,2171,2799,4970,1177,742,26,13,427,1465,1630,2220,3850,716,301,12,9,427,1588,1155,1898,3053,32900,33766,6984,7265,30303,34581,70187,75612,145799
LGA57980,40,126,150,208,358,72,34,0,0,39,132,111,166,277,41,25,4,3,33,121,78,149,227,2653,2740,676,698,2899,3315,6228,6753,12981
LGA58050,203,423,745,812,1557,377,202,5,0,125,426,507,628,1135,163,72,0,0,119,356,282,428,710,18397,19275,3998,4347,14377,15522,36772,39144,75916
LGA58190,8,3,11,7,18,0,0,0,0,0,6,0,6,6,6,0,0,0,0,0,6,0,6,73,72,11,16,66,30,150,118,268
LGA58260,8,0,8,0,8,3,3,0,0,3,5,6,8,14,0,0,0,0,3,5,3,5,8,108,111,26,34,77,52,211,197,408
LGA58330,14,24,63,43,106,17,8,0,0,6,16,23,24,47,10,6,0,0,8,11,18,17,35,832,911,141,177,487,520,1460,1608,3068
LGA58400,0,3,3,3,6,0,0,0,0,0,3,0,3,3,0,0,3,0,0,3,3,3,6,63,62,22,16,45,36,130,114,244
LGA58470,0,0,3,0,3,0,0,0,0,0,0,0,0,0,0,0,0,0,0,0,0,0,0,16,20,13,16,45,35,74,71,145
LGA58510,91,213,232,337,569,146,106,0,3,87,284,233,393,626,106,56,3,0,98,358,207,414,621,4581,4697,1378,1442,5884,5733,11843,11872,23715
LGA58540,6,0,15,3,18,5,3,0,0,3,0,8,3,11,0,3,0,0,3,0,3,3,6,166,172,34,31,136,58,336,261,597
LGA58570,70,172,233,299,532,125,69,0,0,70,206,195,275,470,94,40,0,0,53,237,147,277,424,4254,4398,1759,1725,5583,5513,11596,11636,23232
LGA58610,9,10,25,14,39,6,9,3,0,5,16,14,25,39,5,0,0,0,7,21,12,21,33,345,352,63,66,228,225,636,643,1279
LGA58680,3,0,7,3,10,5,0,0,0,0,3,5,3,8,0,0,0,0,0,0,0,0,0,103,106,22,24,40,17,165,147,312
LGA58760,200,543,1021,1134,2155,462,268,6,4,154,483,622,755,1377,232,104,4,3,145,379,381,486,867,26936,28302,5572,6012,17950,20019,50458,54333,104791
LGA58820,4,21,37,47,84,27,6,0,0,5,20,32,26,58,3,3,4,3,4,16,11,22,33,644,685,131,145,437,446,1212,1276,2488
LGA58890,0,4,7,18,25,9,4,0,0,4,5,13,9,22,6,0,0,0,4,0,10,0,10,207,207,28,31,88,65,323,303,626
LGA59030,0,3,3,3,6,3,0,0,0,0,0,3,0,3,3,0,0,0,0,0,3,0,3,47,50,6,11,31,17,84,78,162
LGA59100,3,4,6,8,14,5,0,0,0,3,0,8,0,8,3,3,0,0,4,4,7,7,14,143,141,24,24,95,73,262,238,500
LGA59170,5,9,12,13,25,6,3,4,0,0,3,10,6,16,3,0,0,0,0,0,3,0,3,199,201,41,38,101,74,341,313,654
LGA59250,3,0,3,0,3,0,3,0,0,0,0,0,3,3,0,0,0,0,0,0,0,0,0,31,25,28,34,72,96,131,155,286
LGA59310,3,3,9,6,15,10,4,0,0,4,9,14,13,27,3,0,0,0,0,8,3,8,11,244,250,64,68,184,139,492,457,949
LGA59320,4,0,8,3,11,3,0,3,0,0,0,6,0,6,0,0,0,0,0,0,0,0,0,83,85,21,21,42,31,146,137,283
LGA59330,3,4,3,10,13,5,0,0,3,3,3,8,6,14,3,0,0,0,3,4,6,4,10,98,97,12,15,69,61,179,173,352
LGA59340,7,6,14,11,25,5,3,0,3,3,6,8,12,20,0,0,3,0,3,4,6,4,10,775,813,436,452,1007,944,2218,2209,4427
LGA59350,0,0,3,0,3,0,0,0,0,0,0,0,0,0,0,0,0,0,0,0,0,0,0,17,16,12,14,26,20,55,50,105
LGA59360,6,0,16,6,22,4,3,0,0,4,3,8,6,14,0,0,0,0,4,3,4,3,7,218,216,53,54,164,94,435,364,799
LGA59370,9,24,54,54,108,21,14,0,0,13,24,34,38,72,6,5,0,0,3,13,9,18,27,660,689,113,128,383,433,1156,1250,2406
LGA59399,0,0,0,0,0,0,0,0,0,0,0,0,0,0,0,0,0,0,0,0,0,0,0,0,0,0,0,0,0,0,0,0
LGA60210,30,38,99,86,185,32,20,0,4,26,53,58,77,135,25,7,0,0,25,43,50,50,100,1105,1128,275,275,861,789,2241,2192,4433
LGA60410,19,57,91,99,190,32,17,4,0,14,47,50,64,114,13,7,0,0,14,35,27,42,69,2282,2324,763,788,1884,2328,4929,5440,10369
LGA60610,56,158,229,284,513,96,59,3,0,40,149,139,208,347,59,29,3,0,47,145,109,174,283,3221,3289,794,851,2480,3215,6495,7355,13850
LGA60810,67,188,294,359,653,132,71,3,0,61,169,196,240,436,68,34,0,0,48,155,116,189,305,4048,4159,745,775,2564,3098,7357,8032,15389
LGA61010,14,9,40,22,62,10,3,0,0,5,11,15,14,29,3,0,0,0,6,9,9,9,18,413,409,116,113,325,236,854,758,1612
LGA61210,33,55,93,97,190,32,16,0,0,11,42,43,58,101,25,11,0,0,16,41,41,52,93,1436,1448,369,384,954,940,2759,2772,5531
LGA61410,154,393,641,749,1390,343,191,3,5,133,441,479,637,1116,196,117,0,0,132,426,328,543,871,9414,9497,1989,2052,6458,8226,17861,19775,37636
LGA61510,39,61,116,112,228,34,23,0,0,31,57,65,80,145,16,10,0,0,20,42,36,52,88,1680,1688,503,529,1370,1313,3553,3530,7083
LGA61610,80,234,321,410,731,171,102,0,0,73,211,244,313,557,96,44,0,0,80,250,176,294,470,4125,4248,965,994,3153,4201,8243,9443,17686
LGA61810,25,49,107,112,219,56,27,0,0,27,69,83,96,179,13,8,0,0,15,44,28,52,80,1302,1309,269,270,855,892,2426,2471,4897
LGA62010,3,3,12,6,18,3,3,0,0,0,4,3,7,10,0,0,0,0,6,3,6,3,9,142,139,44,46,105,85,291,270,561
LGA62210,15,41,86,78,164,29,16,0,0,21,47,50,63,113,13,7,0,0,17,27,30,34,64,1157,1170,295,305,919,931,2371,2406,4777
LGA62410,27,37,88,73,161,21,10,0,0,20,26,41,36,77,10,5,0,0,14,32,24,37,61,796,804,190,190,532,450,1518,1444,2962
LGA62610,165,482,535,767,1302,263,177,3,0,159,420,425,597,1022,137,64,6,5,140,465,283,534,817,6558,6632,2074,2105,7015,8794,15647,17531,33178
LGA62810,114,336,454,588,1042,260,174,4,6,113,365,377,545,922,173,81,0,0,123,451,296,532,828,7373,7511,2086,2096,7875,9196,17334,18803,36137
LGA63010,49,79,201,165,366,80,43,3,0,37,70,120,113,233,29,16,0,0,31,59,60,75,135,2741,2775,764,783,1980,1915,5485,5473,10958
LGA63210,20,20,74,51,125,16,13,3,0,21,26,40,39,79,12,7,0,0,14,28,26,35,61,1163,1202,227,241,802,726,2192,2169,4361
LGA63410,11,10,20,18,38,6,3,0,0,7,8,13,11,24,3,0,0,0,3,18,6,18,24,271,270,81,85,256,181,608,536,1144
LGA63610,76,214,360,440,800,213,108,4,0,64,220,281,328,609,104,40,5,0,57,216,166,256,422,6567,6644,1281,1328,3774,4865,11622,12837,24459
LGA63810,31,90,135,152,287,55,38,3,0,28,70,86,108,194,34,6,0,0,12,65,46,71,117,1915,1954,367,391,1177,1319,3459,3664,7123
LGA64010,210,511,663,896,1559,342,235,7,5,173,508,522,748,1270,207,102,0,3,155,586,362,691,1053,10047,10187,2555,2563,9553,11678,22155,24428,46583
LGA64210,66,158,244,285,529,108,69,0,0,52,142,160,211,371,59,36,3,0,40,129,102,165,267,3732,3806,699,718,2209,2822,6640,7346,13986
LGA64610,48,77,200,173,373,66,39,0,0,23,76,89,115,204,27,10,0,0,36,74,63,84,147,2414,2429,497,513,1521,1629,4432,4571,9003
LGA64810,45,76,150,150,300,70,45,3,0,44,92,117,137,254,41,19,0,0,22,63,63,82,145,2265,2299,682,697,1752,1870,4699,4866,9565
LGA65010,18,33,57,50,107,22,15,0,0,19,29,41,44,85,7,0,0,0,9,32,16,32,48,1153,1154,262,269,813,702,2228,2125,4353
LGA65210,8,15,33,36,69,20,11,0,0,14,11,34,22,56,8,3,0,0,0,10,8,13,21,413,413,129,131,302,250,844,794,1638
LGA65410,43,111,185,214,399,96,59,0,0,46,99,142,158,300,52,17,0,5,26,101,78,123,201,2525,2594,548,566,1725,2033,4798,5193,9991
LGA65610,22,32,49,56,105,14,7,3,0,9,12,26,19,45,8,0,3,0,4,12,15,12,27,693,696,278,293,722,573,1693,1562,3255
LGA65810,68,135,276,314,590,155,73,5,0,61,139,221,212,433,58,35,0,0,51,147,109,182,291,4413,4493,736,762,2509,3020,7658,8275,15933
LGA69399,0,0,0,0,0,0,0,0,0,0,0,0,0,0,0,0,0,0,0,0,0,0,0,0,0,0,0,0,0,0,0,0
LGA70200,31,66,72,88,160,26,12,4,3,31,67,61,82,143,8,6,0,0,11,46,19,52,71,3157,3267,1285,1385,3475,3778,7917,8430,16347
LGA70420,4,16,12,20,32,3,3,0,0,7,13,10,16,26,3,0,0,0,4,14,7,14,21,781,789,221,225,960,1112,1962,2126,4088
LGA70540,0,0,0,0,0,0,0,0,0,0,3,0,3,3,0,0,0,0,0,0,0,0,0,12,10,7,6,46,35,65,51,116
LGA70620,3,14,10,18,28,7,0,0,0,3,9,10,9,19,3,0,0,0,3,15,6,15,21,509,506,47,56,394,574,950,1136,2086
LGA70700,0,9,4,9,13,3,0,0,0,3,3,6,3,9,0,0,0,0,3,0,3,0,3,111,114,63,66,181,145,355,325,680
LGA71000,115,187,335,309,644,98,39,0,3,85,169,183,211,394,40,9,0,3,43,106,83,118,201,9903,10196,3455,3622,10852,10204,24210,24022,48232
LGA71300,4,24,10,24,34,0,0,0,0,4,10,4,10,14,0,0,0,0,5,11,5,11,16,1062,1059,86,90,1621,1778,2769,2927,5696
LGA72200,16,16,36,24,60,9,3,0,0,8,12,17,15,32,0,0,0,0,5,3,5,3,8,1118,1174,474,520,1048,1044,2640,2738,5378
LGA72300,28,29,73,57,130,30,17,0,0,25,16,55,33,88,9,7,0,0,8,16,17,23,40,2580,2740,995,1070,2363,1758,5938,5568,11506
LGA72330,6,20,9,20,29,0,0,0,0,4,7,4,7,11,0,0,3,0,3,6,6,6,12,605,609,141,144,701,923,1447,1676,3123
LGA72800,31,59,69,82,151,21,4,0,0,17,36,38,40,78,6,4,0,0,7,24,13,28,41,3600,3796,1610,1733,3340,3389,8550,8918,17468
LGA73600,13,14,17,14,31,5,3,0,0,6,3,11,6,17,0,0,0,0,6,11,6,11,17,715,720,165,167,905,897,1785,1784,3569
LGA74050,4,0,7,0,7,0,0,0,0,0,3,0,3,3,0,0,0,0,0,0,0,0,0,265,264,156,150,381,391,802,805,1607
LGA74500,14,13,23,13,36,4,3,0,0,5,5,9,8,17,3,0,0,0,0,4,3,4,7,617,616,279,277,768,871,1664,1764,3428
LGA74560,0,0,3,3,6,0,0,0,0,3,0,3,0,3,0,0,0,0,0,0,0,0,0,61,58,27,28,58,41,146,127,273
LGA74660,4,5,4,11,15,0,0,0,0,5,4,5,4,9,0,0,0,0,7,3,7,3,10,781,777,120,127,966,931,1867,1835,3702
LGA79399,4,3,4,3,7,0,0,3,0,0,3,3,3,6,0,0,0,0,0,0,0,0,0,1000,991,361,376,825,477,2186,1844,4030
LGA89399,610,1647,2659,3169,5828,1378,841,25,6,497,1573,1900,2420,4320,809,392,13,3,481,1719,1303,2114,3417,62038,62881,13656,13941,49594,56253,125288,133075,258363
LGA99399,5,7,8,10,18,3,0,0,0,3,7,6,7,13,0,0,0,0,3,0,3,0,3,440,441,45,46,323,199,808,686,1494
